PokerStars Game #6806433552:  Hold'em Limit ($0.50/$1.00) - 2006/10/28 - 19:14:36 (ET)
Table 'Tanina' 10-max Seat #5 is the button
Seat 5: 13BD ($102.25 in chips) 
Seat 6: finztothelft ($23.40 in chips) 
Seat 7: Glide Or ($35.95 in chips) 
Seat 8: 1,1,2,3,5 ($20 in chips) 
Seat 9: migblafi ($17.50 in chips) 
Seat 10: philgordon21 ($9.50 in chips) 
finztothelft: posts small blind $0.25
Glide Or: posts big blind $0.50
1,1,2,3,5: posts big blind $0.50
deepspace68: sits out 
VonMuse: sits out 
*** HOLE CARDS ***
Dealt to 1,1,2,3,5 [9h Kh]
1,1,2,3,5: checks 
migblafi: raises $0.50 to $1
philgordon21: calls $1
13BD: raises $0.50 to $1.50
finztothelft: folds 
Glide Or: calls $1
1,1,2,3,5: folds 
migblafi: calls $0.50
philgordon21: calls $0.50
*** FLOP *** [8d 6d 7d]
Glide Or: checks 
migblafi: bets $0.50
philgordon21: raises $0.50 to $1
13BD: raises $0.50 to $1.50
Glide Or: folds 
migblafi: calls $1
philgordon21: raises $0.50 to $2
Betting is capped
13BD: calls $0.50
migblafi: calls $0.50
*** TURN *** [8d 6d 7d] [2c]
migblafi: bets $1
philgordon21: raises $1 to $2
13BD: calls $2
migblafi: calls $1
*** RIVER *** [8d 6d 7d 2c] [5c]
migblafi: bets $1
philgordon21: calls $1
13BD: calls $1
*** SHOW DOWN ***
migblafi: shows [9c 9d] (a straight, Five to Nine)
philgordon21: mucks hand 
13BD: mucks hand 
migblafi collected $21.25 from pot
*** SUMMARY ***
Total pot $21.75 | Rake $0.50 
Board [8d 6d 7d 2c 5c]
Seat 5: 13BD (button) mucked [Qd Qh]
Seat 6: finztothelft (small blind) folded before Flop
Seat 7: Glide Or (big blind) folded on the Flop
Seat 8: 1,1,2,3,5 folded before Flop
Seat 9: migblafi showed [9c 9d] and won ($21.25) with a straight, Five to Nine
Seat 10: philgordon21 mucked [Jh 7h]



PokerStars Game #6806446459:  Hold'em Limit ($0.50/$1.00) - 2006/10/28 - 19:15:42 (ET)
Table 'Tanina' 10-max Seat #6 is the button
Seat 2: deepspace68 ($25 in chips) 
Seat 5: 13BD ($95.75 in chips) 
Seat 6: finztothelft ($23.15 in chips) 
Seat 7: Glide Or ($34.45 in chips) 
Seat 8: 1,1,2,3,5 ($19.50 in chips) 
Seat 9: migblafi ($32.25 in chips) 
Seat 10: philgordon21 ($3 in chips) 
Glide Or: posts small blind $0.25
1,1,2,3,5: posts big blind $0.50
deepspace68: posts big blind $0.50
VonMuse: sits out 
*** HOLE CARDS ***
Dealt to 1,1,2,3,5 [5s 6s]
migblafi: folds 
philgordon21: raises $0.50 to $1
deepspace68: folds 
13BD: folds 
finztothelft: folds 
Glide Or: folds 
1,1,2,3,5: folds 
philgordon21 collected $1.75 from pot
*** SUMMARY ***
Total pot $1.75 | Rake $0 
Seat 2: deepspace68 folded before Flop
Seat 5: 13BD folded before Flop (didn't bet)
Seat 6: finztothelft (button) folded before Flop (didn't bet)
Seat 7: Glide Or (small blind) folded before Flop
Seat 8: 1,1,2,3,5 (big blind) folded before Flop
Seat 9: migblafi folded before Flop (didn't bet)
Seat 10: philgordon21 collected ($1.75)



PokerStars Game #6806450939:  Hold'em Limit ($0.50/$1.00) - 2006/10/28 - 19:16:05 (ET)
Table 'Tanina' 10-max Seat #7 is the button
Seat 2: deepspace68 ($24.50 in chips) 
Seat 5: 13BD ($95.75 in chips) 
Seat 6: finztothelft ($23.15 in chips) 
Seat 7: Glide Or ($34.20 in chips) 
Seat 8: 1,1,2,3,5 ($19 in chips) 
Seat 9: migblafi ($32.25 in chips) 
Seat 10: philgordon21 ($4.25 in chips) 
1,1,2,3,5: posts small blind $0.25
migblafi: posts big blind $0.50
VonMuse: sits out 
*** HOLE CARDS ***
Dealt to 1,1,2,3,5 [Qd Jh]
philgordon21: folds 
deepspace68: folds 
13BD: folds 
finztothelft: folds 
Glide Or: folds 
1,1,2,3,5: calls $0.25
migblafi: checks 
*** FLOP *** [Kh 7d 6c]
1,1,2,3,5: checks 
migblafi: checks 
*** TURN *** [Kh 7d 6c] [Tc]
1,1,2,3,5: bets $1
migblafi: raises $1 to $2
1,1,2,3,5: calls $1
*** RIVER *** [Kh 7d 6c Tc] [9d]
1,1,2,3,5: bets $1
migblafi: calls $1
*** SHOW DOWN ***
1,1,2,3,5: shows [Qd Jh] (a straight, Nine to King)
migblafi: mucks hand 
1,1,2,3,5 collected $6.70 from pot
*** SUMMARY ***
Total pot $7 | Rake $0.30 
Board [Kh 7d 6c Tc 9d]
Seat 2: deepspace68 folded before Flop (didn't bet)
Seat 5: 13BD folded before Flop (didn't bet)
Seat 6: finztothelft folded before Flop (didn't bet)
Seat 7: Glide Or (button) folded before Flop (didn't bet)
Seat 8: 1,1,2,3,5 (small blind) showed [Qd Jh] and won ($6.70) with a straight, Nine to King
Seat 9: migblafi (big blind) mucked [Td 7h]
Seat 10: philgordon21 folded before Flop (didn't bet)



PokerStars Game #6806458079:  Hold'em Limit ($0.50/$1.00) - 2006/10/28 - 19:16:42 (ET)
Table 'Tanina' 10-max Seat #8 is the button
Seat 2: deepspace68 ($24.50 in chips) 
Seat 5: 13BD ($95.75 in chips) 
Seat 6: finztothelft ($23.15 in chips) 
Seat 7: Glide Or ($34.20 in chips) 
Seat 8: 1,1,2,3,5 ($22.20 in chips) 
Seat 9: migblafi ($28.75 in chips) 
Seat 10: philgordon21 ($4.25 in chips) 
migblafi: posts small blind $0.25
philgordon21: posts big blind $0.50
VonMuse: sits out 
*** HOLE CARDS ***
Dealt to 1,1,2,3,5 [Ts Qs]
deepspace68: folds 
13BD: folds 
finztothelft: folds 
Glide Or: folds 
1,1,2,3,5: calls $0.50
migblafi: calls $0.25
philgordon21: checks 
*** FLOP *** [6s 9s 3c]
migblafi: checks 
philgordon21: bets $0.50
1,1,2,3,5: raises $0.50 to $1
migblafi: folds 
philgordon21: raises $0.50 to $1.50
1,1,2,3,5: calls $0.50
*** TURN *** [6s 9s 3c] [4h]
migblafi leaves the table
philgordon21: bets $1
1,1,2,3,5: calls $1
*** RIVER *** [6s 9s 3c 4h] [5c]
philgordon21: bets $1
1,1,2,3,5: folds 
philgordon21 collected $6.20 from pot
*** SUMMARY ***
Total pot $6.50 | Rake $0.30 
Board [6s 9s 3c 4h 5c]
Seat 2: deepspace68 folded before Flop (didn't bet)
Seat 5: 13BD folded before Flop (didn't bet)
Seat 6: finztothelft folded before Flop (didn't bet)
Seat 7: Glide Or folded before Flop (didn't bet)
Seat 8: 1,1,2,3,5 (button) folded on the River
Seat 9: migblafi (small blind) folded on the Flop
Seat 10: philgordon21 (big blind) collected ($6.20)



PokerStars Game #6806466385:  Hold'em Limit ($0.50/$1.00) - 2006/10/28 - 19:17:24 (ET)
Table 'Tanina' 10-max Seat #10 is the button
Seat 2: deepspace68 ($24.50 in chips) 
Seat 4: VonMuse ($20 in chips) 
Seat 5: 13BD ($95.75 in chips) 
Seat 6: finztothelft ($23.15 in chips) 
Seat 7: Glide Or ($34.20 in chips) 
Seat 8: 1,1,2,3,5 ($19.20 in chips) 
Seat 10: philgordon21 ($7.45 in chips) 
deepspace68: posts small blind $0.25
VonMuse: posts big blind $0.50
*** HOLE CARDS ***
Dealt to 1,1,2,3,5 [5s Qc]
13BD: folds 
finztothelft: folds 
Glide Or: folds 
1,1,2,3,5: folds 
philgordon21: raises $0.50 to $1
deepspace68: folds 
VonMuse: calls $0.50
*** FLOP *** [Qd 7d Jh]
VonMuse: checks 
philgordon21: bets $0.50
VonMuse: folds 
philgordon21 collected $2.15 from pot
*** SUMMARY ***
Total pot $2.25 | Rake $0.10 
Board [Qd 7d Jh]
Seat 2: deepspace68 (small blind) folded before Flop
Seat 4: VonMuse (big blind) folded on the Flop
Seat 5: 13BD folded before Flop (didn't bet)
Seat 6: finztothelft folded before Flop (didn't bet)
Seat 7: Glide Or folded before Flop (didn't bet)
Seat 8: 1,1,2,3,5 folded before Flop (didn't bet)
Seat 10: philgordon21 (button) collected ($2.15)



PokerStars Game #6806472166:  Hold'em Limit ($0.50/$1.00) - 2006/10/28 - 19:17:55 (ET)
Table 'Tanina' 10-max Seat #2 is the button
Seat 2: deepspace68 ($24.25 in chips) 
Seat 4: VonMuse ($19 in chips) 
Seat 5: 13BD ($95.75 in chips) 
Seat 6: finztothelft ($23.15 in chips) 
Seat 7: Glide Or ($34.20 in chips) 
Seat 8: 1,1,2,3,5 ($19.20 in chips) 
Seat 10: philgordon21 ($8.60 in chips) 
VonMuse: posts small blind $0.25
13BD: posts big blind $0.50
*** HOLE CARDS ***
Dealt to 1,1,2,3,5 [9h 8s]
lamb1142 was removed from the table for failing to post
finztothelft: folds 
Glide Or: calls $0.50
1,1,2,3,5: folds 
philgordon21: folds 
Haek82 joins the table at seat #9 
deepspace68: calls $0.50
VonMuse: calls $0.25
13BD: checks 
*** FLOP *** [Qd 6h 4h]
JMAC60 joins the table at seat #1 
VonMuse: checks 
13BD: checks 
Glide Or: checks 
deepspace68: checks 
*** TURN *** [Qd 6h 4h] [Ah]
VonMuse: checks 
13BD: checks 
Glide Or: bets $1
deepspace68: folds 
VonMuse: calls $1
13BD: folds 
*** RIVER *** [Qd 6h 4h Ah] [2c]
VonMuse: checks 
Glide Or: bets $1
VonMuse: folds 
Glide Or collected $3.85 from pot
*** SUMMARY ***
Total pot $4 | Rake $0.15 
Board [Qd 6h 4h Ah 2c]
Seat 2: deepspace68 (button) folded on the Turn
Seat 4: VonMuse (small blind) folded on the River
Seat 5: 13BD (big blind) folded on the Turn
Seat 6: finztothelft folded before Flop (didn't bet)
Seat 7: Glide Or collected ($3.85)
Seat 8: 1,1,2,3,5 folded before Flop (didn't bet)
Seat 10: philgordon21 folded before Flop (didn't bet)



PokerStars Game #6806485798:  Hold'em Limit ($0.50/$1.00) - 2006/10/28 - 19:19:05 (ET)
Table 'Tanina' 10-max Seat #4 is the button
Seat 1: JMAC60 ($20 in chips) 
Seat 2: deepspace68 ($23.75 in chips) 
Seat 4: VonMuse ($17.50 in chips) 
Seat 5: 13BD ($95.25 in chips) 
Seat 6: finztothelft ($23.15 in chips) 
Seat 7: Glide Or ($36.55 in chips) 
Seat 8: 1,1,2,3,5 ($19.20 in chips) 
Seat 10: philgordon21 ($8.60 in chips) 
13BD: posts small blind $0.25
finztothelft: posts big blind $0.50
Haek82: sits out 
JMAC60: posts big blind $0.50
*** HOLE CARDS ***
Dealt to 1,1,2,3,5 [Qh Qs]
Glide Or: calls $0.50
1,1,2,3,5: raises $0.50 to $1
philgordon21: calls $1
JMAC60: folds 
deepspace68: folds 
VonMuse: calls $1
13BD: folds 
finztothelft: folds 
Glide Or: calls $0.50
*** FLOP *** [Js 4c 7d]
Glide Or: checks 
1,1,2,3,5: bets $0.50
philgordon21: calls $0.50
VonMuse: folds 
Glide Or: folds 
*** TURN *** [Js 4c 7d] [3h]
1,1,2,3,5: bets $1
philgordon21: folds 
1,1,2,3,5 collected $5.95 from pot
1,1,2,3,5: doesn't show hand 
*** SUMMARY ***
Total pot $6.25 | Rake $0.30 
Board [Js 4c 7d 3h]
Seat 1: JMAC60 folded before Flop
Seat 2: deepspace68 folded before Flop (didn't bet)
Seat 4: VonMuse (button) folded on the Flop
Seat 5: 13BD (small blind) folded before Flop
Seat 6: finztothelft (big blind) folded before Flop
Seat 7: Glide Or folded on the Flop
Seat 8: 1,1,2,3,5 collected ($5.95)
Seat 10: philgordon21 folded on the Turn



PokerStars Game #6806495305:  Hold'em Limit ($0.50/$1.00) - 2006/10/28 - 19:19:54 (ET)
Table 'Tanina' 10-max Seat #5 is the button
Seat 1: JMAC60 ($19.50 in chips) 
Seat 2: deepspace68 ($23.75 in chips) 
Seat 4: VonMuse ($16.50 in chips) 
Seat 5: 13BD ($95 in chips) 
Seat 6: finztothelft ($22.65 in chips) 
Seat 7: Glide Or ($35.55 in chips) 
Seat 8: 1,1,2,3,5 ($23.65 in chips) 
Seat 10: philgordon21 ($7.10 in chips) 
finztothelft: posts small blind $0.25
Glide Or: posts big blind $0.50
Haek82: sits out 
*** HOLE CARDS ***
Dealt to 1,1,2,3,5 [Js 4s]
1,1,2,3,5: folds 
philgordon21: raises $0.50 to $1
JMAC60: folds 
deepspace68: folds 
VonMuse: folds 
13BD: folds 
finztothelft: calls $0.75
Glide Or: folds 
*** FLOP *** [Qc 2s Ad]
finztothelft has timed out
finztothelft: folds 
finztothelft is sitting out
philgordon21 collected $2.40 from pot
*** SUMMARY ***
Total pot $2.50 | Rake $0.10 
Board [Qc 2s Ad]
Seat 1: JMAC60 folded before Flop (didn't bet)
Seat 2: deepspace68 folded before Flop (didn't bet)
Seat 4: VonMuse folded before Flop (didn't bet)
Seat 5: 13BD (button) folded before Flop (didn't bet)
Seat 6: finztothelft (small blind) folded on the Flop
Seat 7: Glide Or (big blind) folded before Flop
Seat 8: 1,1,2,3,5 folded before Flop (didn't bet)
Seat 10: philgordon21 collected ($2.40)



PokerStars Game #6806502204:  Hold'em Limit ($0.50/$1.00) - 2006/10/28 - 19:20:29 (ET)
Table 'Tanina' 10-max Seat #7 is the button
Seat 1: JMAC60 ($19.50 in chips) 
Seat 2: deepspace68 ($23.75 in chips) 
Seat 4: VonMuse ($16.50 in chips) 
Seat 5: 13BD ($95 in chips) 
Seat 7: Glide Or ($35.05 in chips) 
Seat 8: 1,1,2,3,5 ($23.65 in chips) 
Seat 9: Haek82 ($10 in chips) 
Seat 10: philgordon21 ($8.50 in chips) 
1,1,2,3,5: posts small blind $0.25
Haek82: posts big blind $0.50
*** HOLE CARDS ***
Dealt to 1,1,2,3,5 [Ad Ac]
philgordon21: raises $0.50 to $1
JMAC60: folds 
deepspace68: folds 
VonMuse: raises $0.50 to $1.50
13BD: folds 
Glide Or: folds 
1,1,2,3,5: raises $0.50 to $2
Betting is capped
Haek82: folds 
philgordon21: calls $1
VonMuse: calls $0.50
*** FLOP *** [5s Qd 4d]
finztothelft has returned
1,1,2,3,5: checks 
philgordon21: checks 
VonMuse: bets $0.50
1,1,2,3,5: calls $0.50
philgordon21: calls $0.50
*** TURN *** [5s Qd 4d] [Jd]
1,1,2,3,5: bets $1
philgordon21: calls $1
VonMuse: calls $1
*** RIVER *** [5s Qd 4d Jd] [3d]
1,1,2,3,5: bets $1
philgordon21: folds 
VonMuse: calls $1
*** SHOW DOWN ***
1,1,2,3,5: shows [Ad Ac] (a flush, Ace high)
VonMuse: mucks hand 
1,1,2,3,5 collected $12.50 from pot
*** SUMMARY ***
Total pot $13 | Rake $0.50 
Board [5s Qd 4d Jd 3d]
Seat 1: JMAC60 folded before Flop (didn't bet)
Seat 2: deepspace68 folded before Flop (didn't bet)
Seat 4: VonMuse mucked [Qc Qs]
Seat 5: 13BD folded before Flop (didn't bet)
Seat 7: Glide Or (button) folded before Flop (didn't bet)
Seat 8: 1,1,2,3,5 (small blind) showed [Ad Ac] and won ($12.50) with a flush, Ace high
Seat 9: Haek82 (big blind) folded before Flop
Seat 10: philgordon21 folded on the River



PokerStars Game #6806512854:  Hold'em Limit ($0.50/$1.00) - 2006/10/28 - 19:21:24 (ET)
Table 'Tanina' 10-max Seat #8 is the button
Seat 1: JMAC60 ($19.50 in chips) 
Seat 2: deepspace68 ($23.75 in chips) 
Seat 4: VonMuse ($12 in chips) 
Seat 5: 13BD ($95 in chips) 
Seat 6: finztothelft ($21.65 in chips) 
Seat 7: Glide Or ($35.05 in chips) 
Seat 8: 1,1,2,3,5 ($31.65 in chips) 
Seat 9: Haek82 ($9.50 in chips) 
Seat 10: philgordon21 ($5 in chips) 
Haek82: posts small blind $0.25
philgordon21: posts big blind $0.50
*** HOLE CARDS ***
Dealt to 1,1,2,3,5 [3h 4d]
JMAC60: calls $0.50
deepspace68: folds 
VonMuse: folds 
DrDave6 was removed from the table for failing to post
13BD: folds 
finztothelft: folds 
Glide Or: calls $0.50
1,1,2,3,5: folds 
Haek82: calls $0.25
philgordon21: raises $0.50 to $1
JMAC60: calls $0.50
dogbert888 joins the table at seat #3 
Glide Or: calls $0.50
Haek82: calls $0.50
*** FLOP *** [5c 7h 7s]
Haek82: checks 
philgordon21: bets $0.50
JMAC60: folds 
Glide Or: calls $0.50
Haek82: calls $0.50
*** TURN *** [5c 7h 7s] [Ah]
Haek82: bets $1
philgordon21: raises $1 to $2
Glide Or: folds 
Haek82: calls $1
*** RIVER *** [5c 7h 7s Ah] [Qd]
Haek82: checks 
philgordon21: bets $1
Haek82: calls $1
*** SHOW DOWN ***
philgordon21: shows [9s 5s] (two pair, Sevens and Fives)
Haek82: shows [As Th] (two pair, Aces and Sevens)
Haek82 collected $11 from pot
*** SUMMARY ***
Total pot $11.50 | Rake $0.50 
Board [5c 7h 7s Ah Qd]
Seat 1: JMAC60 folded on the Flop
Seat 2: deepspace68 folded before Flop (didn't bet)
Seat 4: VonMuse folded before Flop (didn't bet)
Seat 5: 13BD folded before Flop (didn't bet)
Seat 6: finztothelft folded before Flop (didn't bet)
Seat 7: Glide Or folded on the Turn
Seat 8: 1,1,2,3,5 (button) folded before Flop (didn't bet)
Seat 9: Haek82 (small blind) showed [As Th] and won ($11) with two pair, Aces and Sevens
Seat 10: philgordon21 (big blind) showed [9s 5s] and lost with two pair, Sevens and Fives



PokerStars Game #6806525513:  Hold'em Limit ($0.50/$1.00) - 2006/10/28 - 19:22:30 (ET)
Table 'Tanina' 10-max Seat #9 is the button
Seat 1: JMAC60 ($18.50 in chips) 
Seat 2: deepspace68 ($23.75 in chips) 
Seat 4: VonMuse ($12 in chips) 
Seat 5: 13BD ($95 in chips) 
Seat 6: finztothelft ($21.65 in chips) 
Seat 7: Glide Or ($33.55 in chips) 
Seat 8: 1,1,2,3,5 ($31.65 in chips) 
Seat 9: Haek82 ($16 in chips) 
Seat 10: philgordon21 ($0.50 in chips) 
philgordon21: posts small blind $0.25
JMAC60: posts big blind $0.50
dogbert888: sits out 
*** HOLE CARDS ***
Dealt to 1,1,2,3,5 [Ad Ah]
deepspace68: calls $0.50
VonMuse: folds 
13BD: folds 
finztothelft: folds 
Glide Or: calls $0.50
1,1,2,3,5: raises $0.50 to $1
Haek82: folds 
philgordon21: calls $0.25 and is all-in
JMAC60: calls $0.50
deepspace68: calls $0.50
Glide Or: calls $0.50
*** FLOP *** [Kd 7d 3h]
JMAC60: checks 
deepspace68: checks 
Glide Or: checks 
1,1,2,3,5: bets $0.50
JMAC60: folds 
deepspace68: calls $0.50
Glide Or: calls $0.50
*** TURN *** [Kd 7d 3h] [6h]
deepspace68: checks 
Glide Or: checks 
1,1,2,3,5: bets $1
deepspace68: calls $1
Glide Or: calls $1
*** RIVER *** [Kd 7d 3h 6h] [4s]
deepspace68: checks 
Glide Or: checks 
1,1,2,3,5: bets $1
deepspace68: raises $1 to $2
Glide Or: folds 
1,1,2,3,5: calls $1
*** SHOW DOWN ***
deepspace68: shows [6d 6s] (three of a kind, Sixes)
1,1,2,3,5: mucks hand 
deepspace68 collected $10.10 from side pot
philgordon21: mucks hand 
deepspace68 collected $2.40 from main pot
*** SUMMARY ***
Total pot $13 Main pot $2.40. Side pot $10.10. | Rake $0.50 
Board [Kd 7d 3h 6h 4s]
Seat 1: JMAC60 (big blind) folded on the Flop
Seat 2: deepspace68 showed [6d 6s] and won ($12.50) with three of a kind, Sixes
Seat 4: VonMuse folded before Flop (didn't bet)
Seat 5: 13BD folded before Flop (didn't bet)
Seat 6: finztothelft folded before Flop (didn't bet)
Seat 7: Glide Or folded on the River
Seat 8: 1,1,2,3,5 mucked [Ad Ah]
Seat 9: Haek82 (button) folded before Flop (didn't bet)
Seat 10: philgordon21 (small blind) mucked [8d As]



PokerStars Game #6806540617:  Hold'em Limit ($0.50/$1.00) - 2006/10/28 - 19:23:49 (ET)
Table 'Tanina' 10-max Seat #1 is the button
Seat 1: JMAC60 ($17.50 in chips) 
Seat 2: deepspace68 ($31.75 in chips) 
Seat 3: dogbert888 ($20 in chips) 
Seat 4: VonMuse ($12 in chips) 
Seat 5: 13BD ($95 in chips) 
Seat 6: finztothelft ($21.65 in chips) 
Seat 7: Glide Or ($31.05 in chips) 
Seat 8: 1,1,2,3,5 ($27.15 in chips) 
Seat 9: Haek82 ($16 in chips) 
deepspace68: posts small blind $0.25
dogbert888: posts big blind $0.50
*** HOLE CARDS ***
Dealt to 1,1,2,3,5 [8d 5s]
VonMuse: calls $0.50
13BD: folds 
finztothelft: folds 
Glide Or: calls $0.50
1,1,2,3,5: folds 
Haek82: raises $0.50 to $1
JMAC60: folds 
philgordon21 leaves the table
deepspace68: folds 
dogbert888: folds 
VonMuse: calls $0.50
Glide Or: calls $0.50
*** FLOP *** [Tc 7c 7d]
VonMuse: checks 
Glide Or: checks 
Haek82: bets $0.50
VonMuse: folds 
Glide Or: folds 
Glide Or leaves the table
Haek82 collected $3.60 from pot
*** SUMMARY ***
Total pot $3.75 | Rake $0.15 
Board [Tc 7c 7d]
Seat 1: JMAC60 (button) folded before Flop (didn't bet)
Seat 2: deepspace68 (small blind) folded before Flop
Seat 3: dogbert888 (big blind) folded before Flop
Seat 4: VonMuse folded on the Flop
Seat 5: 13BD folded before Flop (didn't bet)
Seat 6: finztothelft folded before Flop (didn't bet)
Seat 7: Glide Or folded on the Flop
Seat 8: 1,1,2,3,5 folded before Flop (didn't bet)
Seat 9: Haek82 collected ($3.60)



PokerStars Game #6806547571:  Hold'em Limit ($0.50/$1.00) - 2006/10/28 - 19:24:26 (ET)
Table 'Tanina' 10-max Seat #2 is the button
Seat 1: JMAC60 ($17.50 in chips) 
Seat 2: deepspace68 ($31.50 in chips) 
Seat 3: dogbert888 ($19.50 in chips) 
Seat 4: VonMuse ($11 in chips) 
Seat 5: 13BD ($95 in chips) 
Seat 6: finztothelft ($21.65 in chips) 
Seat 8: 1,1,2,3,5 ($27.15 in chips) 
Seat 9: Haek82 ($18.60 in chips) 
dogbert888: posts small blind $0.25
VonMuse: posts big blind $0.50
*** HOLE CARDS ***
Dealt to 1,1,2,3,5 [9s 8d]
psychomacke joins the table at seat #10 
13BD: folds 
finztothelft: folds 
1,1,2,3,5: folds 
Haek82: folds 
JMAC60: folds 
peakrnr joins the table at seat #7 
deepspace68: folds 
dogbert888: calls $0.25
VonMuse: checks 
*** FLOP *** [9h Ac Qd]
psychomacke leaves the table
dogbert888: bets $0.50
VonMuse: folds 
dogbert888 collected $0.95 from pot
*** SUMMARY ***
Total pot $1 | Rake $0.05 
Board [9h Ac Qd]
Seat 1: JMAC60 folded before Flop (didn't bet)
Seat 2: deepspace68 (button) folded before Flop (didn't bet)
Seat 3: dogbert888 (small blind) collected ($0.95)
Seat 4: VonMuse (big blind) folded on the Flop
Seat 5: 13BD folded before Flop (didn't bet)
Seat 6: finztothelft folded before Flop (didn't bet)
Seat 8: 1,1,2,3,5 folded before Flop (didn't bet)
Seat 9: Haek82 folded before Flop (didn't bet)



PokerStars Game #6806552887:  Hold'em Limit ($0.50/$1.00) - 2006/10/28 - 19:24:54 (ET)
Table 'Tanina' 10-max Seat #3 is the button
Seat 1: JMAC60 ($17.50 in chips) 
Seat 2: deepspace68 ($31.50 in chips) 
Seat 3: dogbert888 ($19.95 in chips) 
Seat 4: VonMuse ($10.50 in chips) 
Seat 5: 13BD ($95 in chips) 
Seat 6: finztothelft ($21.65 in chips) 
Seat 8: 1,1,2,3,5 ($27.15 in chips) 
Seat 9: Haek82 ($18.60 in chips) 
VonMuse: posts small blind $0.25
13BD: posts big blind $0.50
peakrnr: sits out 
*** HOLE CARDS ***
Dealt to 1,1,2,3,5 [2d Qs]
finztothelft: folds 
1,1,2,3,5: folds 
Haek82: folds 
JMAC60: raises $0.50 to $1
deepspace68: folds 
dogbert888: folds 
VonMuse: folds 
13BD: folds 
JMAC60 collected $1.25 from pot
JMAC60: doesn't show hand 
*** SUMMARY ***
Total pot $1.25 | Rake $0 
Seat 1: JMAC60 collected ($1.25)
Seat 2: deepspace68 folded before Flop (didn't bet)
Seat 3: dogbert888 (button) folded before Flop (didn't bet)
Seat 4: VonMuse (small blind) folded before Flop
Seat 5: 13BD (big blind) folded before Flop
Seat 6: finztothelft folded before Flop (didn't bet)
Seat 8: 1,1,2,3,5 folded before Flop (didn't bet)
Seat 9: Haek82 folded before Flop (didn't bet)



PokerStars Game #6806556334:  Hold'em Limit ($0.50/$1.00) - 2006/10/28 - 19:25:13 (ET)
Table 'Tanina' 10-max Seat #4 is the button
Seat 1: JMAC60 ($18.25 in chips) 
Seat 2: deepspace68 ($31.50 in chips) 
Seat 3: dogbert888 ($19.95 in chips) 
Seat 4: VonMuse ($10.25 in chips) 
Seat 5: 13BD ($94.50 in chips) 
Seat 6: finztothelft ($21.65 in chips) 
Seat 8: 1,1,2,3,5 ($27.15 in chips) 
Seat 9: Haek82 ($18.60 in chips) 
13BD: posts small blind $0.25
finztothelft: posts big blind $0.50
peakrnr: sits out 
*** HOLE CARDS ***
Dealt to 1,1,2,3,5 [2s 6c]
1,1,2,3,5: folds 
Haek82: calls $0.50
JMAC60: folds 
deepspace68: calls $0.50
dogbert888: folds 
VonMuse: folds 
13BD: calls $0.25
RUSTY W 2 joins the table at seat #10 
finztothelft: checks 
*** FLOP *** [Th Qh 5s]
13BD: bets $0.50
finztothelft: calls $0.50
Haek82: calls $0.50
deepspace68: folds 
*** TURN *** [Th Qh 5s] [9s]
13BD: checks 
finztothelft: checks 
Haek82: checks 
*** RIVER *** [Th Qh 5s 9s] [7s]
13BD: checks 
finztothelft: checks 
Haek82: checks 
*** SHOW DOWN ***
13BD: shows [3h 8h] (high card Queen)
finztothelft: shows [Tc 2c] (a pair of Tens)
Haek82: mucks hand 
finztothelft collected $3.35 from pot
*** SUMMARY ***
Total pot $3.50 | Rake $0.15 
Board [Th Qh 5s 9s 7s]
Seat 1: JMAC60 folded before Flop (didn't bet)
Seat 2: deepspace68 folded on the Flop
Seat 3: dogbert888 folded before Flop (didn't bet)
Seat 4: VonMuse (button) folded before Flop (didn't bet)
Seat 5: 13BD (small blind) showed [3h 8h] and lost with high card Queen
Seat 6: finztothelft (big blind) showed [Tc 2c] and won ($3.35) with a pair of Tens
Seat 8: 1,1,2,3,5 folded before Flop (didn't bet)
Seat 9: Haek82 mucked [Jh 7h]



PokerStars Game #6806570552:  Hold'em Limit ($0.50/$1.00) - 2006/10/28 - 19:26:28 (ET)
Table 'Tanina' 10-max Seat #5 is the button
Seat 1: JMAC60 ($18.25 in chips) 
Seat 2: deepspace68 ($31 in chips) 
Seat 3: dogbert888 ($19.95 in chips) 
Seat 4: VonMuse ($10.25 in chips) 
Seat 5: 13BD ($93.50 in chips) 
Seat 6: finztothelft ($24 in chips) 
Seat 7: peakrnr ($20 in chips) 
Seat 8: 1,1,2,3,5 ($27.15 in chips) 
Seat 9: Haek82 ($17.60 in chips) 
Seat 10: RUSTY W 2 ($38.25 in chips) 
finztothelft: posts small blind $0.25
peakrnr: posts big blind $0.50
RUSTY W 2: posts big blind $0.50
*** HOLE CARDS ***
Dealt to 1,1,2,3,5 [Kc Js]
1,1,2,3,5: folds 
Haek82: folds 
RUSTY W 2: checks 
JMAC60: folds 
deepspace68: calls $0.50
dogbert888 has timed out
dogbert888: folds 
dogbert888 is sitting out
dogbert888 has returned
VonMuse: folds 
13BD: folds 
finztothelft: raises $0.50 to $1
peakrnr: folds 
RUSTY W 2: calls $0.50
deepspace68: calls $0.50
*** FLOP *** [Jc 9d Ac]
finztothelft: bets $0.50
RUSTY W 2: folds 
deepspace68: calls $0.50
*** TURN *** [Jc 9d Ac] [4d]
finztothelft: bets $1
deepspace68: calls $1
*** RIVER *** [Jc 9d Ac 4d] [Jh]
finztothelft: checks 
deepspace68: bets $1
finztothelft: calls $1
*** SHOW DOWN ***
deepspace68: shows [8s Ad] (two pair, Aces and Jacks)
finztothelft: mucks hand 
deepspace68 collected $8.10 from pot
*** SUMMARY ***
Total pot $8.50 | Rake $0.40 
Board [Jc 9d Ac 4d Jh]
Seat 1: JMAC60 folded before Flop (didn't bet)
Seat 2: deepspace68 showed [8s Ad] and won ($8.10) with two pair, Aces and Jacks
Seat 3: dogbert888 folded before Flop (didn't bet)
Seat 4: VonMuse folded before Flop (didn't bet)
Seat 5: 13BD (button) folded before Flop (didn't bet)
Seat 6: finztothelft (small blind) mucked [Qd Qc]
Seat 7: peakrnr (big blind) folded before Flop
Seat 8: 1,1,2,3,5 folded before Flop (didn't bet)
Seat 9: Haek82 folded before Flop (didn't bet)
Seat 10: RUSTY W 2 folded on the Flop



PokerStars Game #6806587163:  Hold'em Limit ($0.50/$1.00) - 2006/10/28 - 19:27:56 (ET)
Table 'Tanina' 10-max Seat #6 is the button
Seat 1: JMAC60 ($18.25 in chips) 
Seat 2: deepspace68 ($35.60 in chips) 
Seat 3: dogbert888 ($19.95 in chips) 
Seat 4: VonMuse ($10.25 in chips) 
Seat 5: 13BD ($93.50 in chips) 
Seat 6: finztothelft ($20.50 in chips) 
Seat 7: peakrnr ($19.50 in chips) 
Seat 8: 1,1,2,3,5 ($27.15 in chips) 
Seat 9: Haek82 ($17.60 in chips) 
Seat 10: RUSTY W 2 ($37.25 in chips) 
peakrnr: posts small blind $0.25
1,1,2,3,5: posts big blind $0.50
*** HOLE CARDS ***
Dealt to 1,1,2,3,5 [6s Qs]
Haek82: folds 
RUSTY W 2: calls $0.50
JMAC60: calls $0.50
deepspace68: calls $0.50
dogbert888: folds 
VonMuse: calls $0.50
13BD: folds 
finztothelft: calls $0.50
peakrnr: folds 
1,1,2,3,5: checks 
*** FLOP *** [8d Ah 2s]
1,1,2,3,5: checks 
RUSTY W 2: bets $0.50
JMAC60: folds 
deepspace68: calls $0.50
VonMuse: folds 
finztothelft: folds 
1,1,2,3,5: folds 
*** TURN *** [8d Ah 2s] [3c]
RUSTY W 2: bets $1
VonMuse leaves the table
deepspace68: calls $1
*** RIVER *** [8d Ah 2s 3c] [4c]
RUSTY W 2: bets $1
deepspace68: calls $1
*** SHOW DOWN ***
RUSTY W 2: shows [8s Ad] (two pair, Aces and Eights)
Deadlydoji joins the table at seat #4 
deepspace68: mucks hand 
RUSTY W 2 collected $7.90 from pot
*** SUMMARY ***
Total pot $8.25 | Rake $0.35 
Board [8d Ah 2s 3c 4c]
Seat 1: JMAC60 folded on the Flop
Seat 2: deepspace68 mucked [As 7s]
Seat 3: dogbert888 folded before Flop (didn't bet)
Seat 4: VonMuse folded on the Flop
Seat 5: 13BD folded before Flop (didn't bet)
Seat 6: finztothelft (button) folded on the Flop
Seat 7: peakrnr (small blind) folded before Flop
Seat 8: 1,1,2,3,5 (big blind) folded on the Flop
Seat 9: Haek82 folded before Flop (didn't bet)
Seat 10: RUSTY W 2 showed [8s Ad] and won ($7.90) with two pair, Aces and Eights



PokerStars Game #6806599479:  Hold'em Limit ($0.50/$1.00) - 2006/10/28 - 19:29:01 (ET)
Table 'Tanina' 10-max Seat #7 is the button
Seat 1: JMAC60 ($17.75 in chips) 
Seat 2: deepspace68 ($32.60 in chips) 
Seat 3: dogbert888 ($19.95 in chips) 
Seat 5: 13BD ($93.50 in chips) 
Seat 6: finztothelft ($20 in chips) 
Seat 7: peakrnr ($19.25 in chips) 
Seat 8: 1,1,2,3,5 ($26.65 in chips) 
Seat 9: Haek82 ($17.60 in chips) 
Seat 10: RUSTY W 2 ($42.15 in chips) 
1,1,2,3,5: posts small blind $0.25
Haek82: posts big blind $0.50
Deadlydoji: sits out 
*** HOLE CARDS ***
Dealt to 1,1,2,3,5 [8s Qs]
RUSTY W 2: calls $0.50
JMAC60: folds 
deepspace68: folds 
dogbert888: folds 
13BD: folds 
finztothelft: folds 
peakrnr: folds 
1,1,2,3,5: calls $0.25
Haek82: checks 
*** FLOP *** [4d Kc 5h]
1,1,2,3,5: checks 
Haek82: bets $0.50
RUSTY W 2: calls $0.50
1,1,2,3,5: folds 
*** TURN *** [4d Kc 5h] [3h]
Haek82: bets $1
RUSTY W 2: calls $1
*** RIVER *** [4d Kc 5h 3h] [Jh]
Haek82: bets $1
RUSTY W 2: folds 
Haek82 collected $4.30 from pot
*** SUMMARY ***
Total pot $4.50 | Rake $0.20 
Board [4d Kc 5h 3h Jh]
Seat 1: JMAC60 folded before Flop (didn't bet)
Seat 2: deepspace68 folded before Flop (didn't bet)
Seat 3: dogbert888 folded before Flop (didn't bet)
Seat 5: 13BD folded before Flop (didn't bet)
Seat 6: finztothelft folded before Flop (didn't bet)
Seat 7: peakrnr (button) folded before Flop (didn't bet)
Seat 8: 1,1,2,3,5 (small blind) folded on the Flop
Seat 9: Haek82 (big blind) collected ($4.30)
Seat 10: RUSTY W 2 folded on the River



PokerStars Game #6806609701:  Hold'em Limit ($0.50/$1.00) - 2006/10/28 - 19:29:54 (ET)
Table 'Tanina' 10-max Seat #8 is the button
Seat 1: JMAC60 ($17.75 in chips) 
Seat 2: deepspace68 ($32.60 in chips) 
Seat 3: dogbert888 ($19.95 in chips) 
Seat 5: 13BD ($93.50 in chips) 
Seat 6: finztothelft ($20 in chips) 
Seat 7: peakrnr ($19.25 in chips) 
Seat 8: 1,1,2,3,5 ($26.15 in chips) 
Seat 9: Haek82 ($19.90 in chips) 
Seat 10: RUSTY W 2 ($40.15 in chips) 
Haek82: posts small blind $0.25
RUSTY W 2: posts big blind $0.50
Deadlydoji: sits out 
*** HOLE CARDS ***
Dealt to 1,1,2,3,5 [7s 6h]
JMAC60: folds 
deepspace68: folds 
dogbert888: folds 
13BD: folds 
finztothelft: folds 
peakrnr: folds 
1,1,2,3,5: folds 
Haek82: calls $0.25
RUSTY W 2: checks 
*** FLOP *** [Jc As 6d]
Haek82: checks 
RUSTY W 2: checks 
*** TURN *** [Jc As 6d] [5d]
Haek82: checks 
RUSTY W 2: bets $1
Haek82: folds 
RUSTY W 2 collected $0.95 from pot
*** SUMMARY ***
Total pot $1 | Rake $0.05 
Board [Jc As 6d 5d]
Seat 1: JMAC60 folded before Flop (didn't bet)
Seat 2: deepspace68 folded before Flop (didn't bet)
Seat 3: dogbert888 folded before Flop (didn't bet)
Seat 5: 13BD folded before Flop (didn't bet)
Seat 6: finztothelft folded before Flop (didn't bet)
Seat 7: peakrnr folded before Flop (didn't bet)
Seat 8: 1,1,2,3,5 (button) folded before Flop (didn't bet)
Seat 9: Haek82 (small blind) folded on the Turn
Seat 10: RUSTY W 2 (big blind) collected ($0.95)



PokerStars Game #6806618803:  Hold'em Limit ($0.50/$1.00) - 2006/10/28 - 19:30:40 (ET)
Table 'Tanina' 10-max Seat #9 is the button
Seat 1: JMAC60 ($17.75 in chips) 
Seat 2: deepspace68 ($32.60 in chips) 
Seat 3: dogbert888 ($19.95 in chips) 
Seat 5: 13BD ($93.50 in chips) 
Seat 6: finztothelft ($20 in chips) 
Seat 7: peakrnr ($19.25 in chips) 
Seat 8: 1,1,2,3,5 ($26.15 in chips) 
Seat 9: Haek82 ($19.40 in chips) 
Seat 10: RUSTY W 2 ($40.60 in chips) 
RUSTY W 2: posts small blind $0.25
JMAC60: posts big blind $0.50
Deadlydoji: sits out 
*** HOLE CARDS ***
Dealt to 1,1,2,3,5 [7c Jc]
deepspace68: raises $0.50 to $1
dogbert888: calls $1
13BD: folds 
finztothelft: folds 
peakrnr: calls $1
1,1,2,3,5: folds 
Haek82: folds 
RUSTY W 2: folds 
JMAC60: folds 
*** FLOP *** [Ts Td 2h]
deepspace68: bets $0.50
dogbert888: raises $0.50 to $1
peakrnr: folds 
deepspace68: calls $0.50
*** TURN *** [Ts Td 2h] [Ah]
deepspace68: checks 
dogbert888: bets $1
deepspace68: calls $1
*** RIVER *** [Ts Td 2h Ah] [6s]
deepspace68: bets $1
dogbert888: calls $1
*** SHOW DOWN ***
deepspace68: shows [As Qc] (two pair, Aces and Tens)
dogbert888: mucks hand 
deepspace68 collected $9.30 from pot
*** SUMMARY ***
Total pot $9.75 | Rake $0.45 
Board [Ts Td 2h Ah 6s]
Seat 1: JMAC60 (big blind) folded before Flop
Seat 2: deepspace68 showed [As Qc] and won ($9.30) with two pair, Aces and Tens
Seat 3: dogbert888 mucked [9c Ac]
Seat 5: 13BD folded before Flop (didn't bet)
Seat 6: finztothelft folded before Flop (didn't bet)
Seat 7: peakrnr folded on the Flop
Seat 8: 1,1,2,3,5 folded before Flop (didn't bet)
Seat 9: Haek82 (button) folded before Flop (didn't bet)
Seat 10: RUSTY W 2 (small blind) folded before Flop



PokerStars Game #6806630143:  Hold'em Limit ($0.50/$1.00) - 2006/10/28 - 19:31:38 (ET)
Table 'Tanina' 10-max Seat #10 is the button
Seat 1: JMAC60 ($17.25 in chips) 
Seat 2: deepspace68 ($37.90 in chips) 
Seat 3: dogbert888 ($15.95 in chips) 
Seat 5: 13BD ($93.50 in chips) 
Seat 6: finztothelft ($20 in chips) 
Seat 7: peakrnr ($18.25 in chips) 
Seat 8: 1,1,2,3,5 ($26.15 in chips) 
Seat 9: Haek82 ($19.40 in chips) 
Seat 10: RUSTY W 2 ($40.35 in chips) 
JMAC60: posts small blind $0.25
deepspace68: posts big blind $0.50
Deadlydoji: sits out 
*** HOLE CARDS ***
Dealt to 1,1,2,3,5 [2h 5d]
dogbert888: calls $0.50
13BD: folds 
finztothelft: folds 
peakrnr: folds 
1,1,2,3,5: folds 
Haek82: folds 
RUSTY W 2: calls $0.50
JMAC60: folds 
deepspace68: checks 
*** FLOP *** [Kh 6s Jh]
deepspace68: bets $0.50
dogbert888: calls $0.50
RUSTY W 2: folds 
*** TURN *** [Kh 6s Jh] [5c]
deepspace68: bets $1
dogbert888: calls $1
*** RIVER *** [Kh 6s Jh 5c] [4s]
deepspace68: bets $1
dogbert888: folds 
deepspace68 collected $4.55 from pot
*** SUMMARY ***
Total pot $4.75 | Rake $0.20 
Board [Kh 6s Jh 5c 4s]
Seat 1: JMAC60 (small blind) folded before Flop
Seat 2: deepspace68 (big blind) collected ($4.55)
Seat 3: dogbert888 folded on the River
Seat 5: 13BD folded before Flop (didn't bet)
Seat 6: finztothelft folded before Flop (didn't bet)
Seat 7: peakrnr folded before Flop (didn't bet)
Seat 8: 1,1,2,3,5 folded before Flop (didn't bet)
Seat 9: Haek82 folded before Flop (didn't bet)
Seat 10: RUSTY W 2 (button) folded on the Flop



PokerStars Game #6806639149:  Hold'em Limit ($0.50/$1.00) - 2006/10/28 - 19:32:24 (ET)
Table 'Tanina' 10-max Seat #1 is the button
Seat 1: JMAC60 ($17 in chips) 
Seat 2: deepspace68 ($40.45 in chips) 
Seat 3: dogbert888 ($13.95 in chips) 
Seat 5: 13BD ($93.50 in chips) 
Seat 6: finztothelft ($20 in chips) 
Seat 7: peakrnr ($18.25 in chips) 
Seat 8: 1,1,2,3,5 ($26.15 in chips) 
Seat 9: Haek82 ($19.40 in chips) 
Seat 10: RUSTY W 2 ($39.85 in chips) 
deepspace68: posts small blind $0.25
dogbert888: posts big blind $0.50
Deadlydoji: sits out 
*** HOLE CARDS ***
Dealt to 1,1,2,3,5 [3h 6s]
13BD: folds 
finztothelft: folds 
peakrnr: folds 
1,1,2,3,5: folds 
Haek82: folds 
RUSTY W 2: folds 
JMAC60: folds 
deepspace68: raises $0.50 to $1
dogbert888: folds 
deepspace68 collected $1 from pot
*** SUMMARY ***
Total pot $1 | Rake $0 
Seat 1: JMAC60 (button) folded before Flop (didn't bet)
Seat 2: deepspace68 (small blind) collected ($1)
Seat 3: dogbert888 (big blind) folded before Flop
Seat 5: 13BD folded before Flop (didn't bet)
Seat 6: finztothelft folded before Flop (didn't bet)
Seat 7: peakrnr folded before Flop (didn't bet)
Seat 8: 1,1,2,3,5 folded before Flop (didn't bet)
Seat 9: Haek82 folded before Flop (didn't bet)
Seat 10: RUSTY W 2 folded before Flop (didn't bet)



PokerStars Game #6806643815:  Hold'em Limit ($0.50/$1.00) - 2006/10/28 - 19:32:48 (ET)
Table 'Tanina' 10-max Seat #2 is the button
Seat 1: JMAC60 ($17 in chips) 
Seat 2: deepspace68 ($40.95 in chips) 
Seat 3: dogbert888 ($13.45 in chips) 
Seat 4: Deadlydoji ($20 in chips) 
Seat 5: 13BD ($93.50 in chips) 
Seat 6: finztothelft ($20 in chips) 
Seat 7: peakrnr ($18.25 in chips) 
Seat 8: 1,1,2,3,5 ($26.15 in chips) 
Seat 9: Haek82 ($19.40 in chips) 
Seat 10: RUSTY W 2 ($39.85 in chips) 
dogbert888: posts small blind $0.25
Deadlydoji: posts big blind $0.50
*** HOLE CARDS ***
Dealt to 1,1,2,3,5 [2d 3d]
13BD: folds 
finztothelft: folds 
peakrnr: folds 
1,1,2,3,5: folds 
Haek82: folds 
RUSTY W 2: calls $0.50
JMAC60: raises $0.50 to $1
deepspace68: folds 
dogbert888: folds 
Deadlydoji: calls $0.50
RUSTY W 2: calls $0.50
*** FLOP *** [4c Jc Qs]
Deadlydoji: checks 
RUSTY W 2: bets $0.50
JMAC60: raises $0.50 to $1
Deadlydoji: folds 
RUSTY W 2: calls $0.50
*** TURN *** [4c Jc Qs] [8d]
RUSTY W 2: checks 
JMAC60: checks 
*** RIVER *** [4c Jc Qs 8d] [Qh]
RUSTY W 2: bets $1
JMAC60: calls $1
*** SHOW DOWN ***
RUSTY W 2: shows [Qd Ks] (three of a kind, Queens)
JMAC60: mucks hand 
RUSTY W 2 collected $6.90 from pot
*** SUMMARY ***
Total pot $7.25 | Rake $0.35 
Board [4c Jc Qs 8d Qh]
Seat 1: JMAC60 mucked [Ad Th]
Seat 2: deepspace68 (button) folded before Flop (didn't bet)
Seat 3: dogbert888 (small blind) folded before Flop
Seat 4: Deadlydoji (big blind) folded on the Flop
Seat 5: 13BD folded before Flop (didn't bet)
Seat 6: finztothelft folded before Flop (didn't bet)
Seat 7: peakrnr folded before Flop (didn't bet)
Seat 8: 1,1,2,3,5 folded before Flop (didn't bet)
Seat 9: Haek82 folded before Flop (didn't bet)
Seat 10: RUSTY W 2 showed [Qd Ks] and won ($6.90) with three of a kind, Queens



PokerStars Game #6806653484:  Hold'em Limit ($0.50/$1.00) - 2006/10/28 - 19:33:37 (ET)
Table 'Tanina' 10-max Seat #3 is the button
Seat 1: JMAC60 ($14 in chips) 
Seat 2: deepspace68 ($40.95 in chips) 
Seat 3: dogbert888 ($13.20 in chips) 
Seat 4: Deadlydoji ($19 in chips) 
Seat 6: finztothelft ($20 in chips) 
Seat 7: peakrnr ($18.25 in chips) 
Seat 8: 1,1,2,3,5 ($26.15 in chips) 
Seat 9: Haek82 ($19.40 in chips) 
Seat 10: RUSTY W 2 ($43.75 in chips) 
Deadlydoji: posts small blind $0.25
13BD: is sitting out 
finztothelft: posts big blind $0.50
*** HOLE CARDS ***
Dealt to 1,1,2,3,5 [Jd 6c]
peakrnr: folds 
1,1,2,3,5: folds 
Haek82: calls $0.50
RUSTY W 2: folds 
JMAC60: folds 
deepspace68: folds 
dogbert888: folds 
Deadlydoji: calls $0.25
finztothelft: checks 
*** FLOP *** [4c 5d Ts]
Deadlydoji: bets $0.50
finztothelft: folds 
Haek82: folds 
Deadlydoji collected $1.45 from pot
*** SUMMARY ***
Total pot $1.50 | Rake $0.05 
Board [4c 5d Ts]
Seat 1: JMAC60 folded before Flop (didn't bet)
Seat 2: deepspace68 folded before Flop (didn't bet)
Seat 3: dogbert888 (button) folded before Flop (didn't bet)
Seat 4: Deadlydoji (small blind) collected ($1.45)
Seat 6: finztothelft (big blind) folded on the Flop
Seat 7: peakrnr folded before Flop (didn't bet)
Seat 8: 1,1,2,3,5 folded before Flop (didn't bet)
Seat 9: Haek82 folded on the Flop
Seat 10: RUSTY W 2 folded before Flop (didn't bet)



PokerStars Game #6806660986:  Hold'em Limit ($0.50/$1.00) - 2006/10/28 - 19:34:16 (ET)
Table 'Tanina' 10-max Seat #4 is the button
Seat 1: JMAC60 ($14 in chips) 
Seat 2: deepspace68 ($40.95 in chips) 
Seat 3: dogbert888 ($13.20 in chips) 
Seat 4: Deadlydoji ($19.95 in chips) 
Seat 6: finztothelft ($19.50 in chips) 
Seat 7: peakrnr ($18.25 in chips) 
Seat 8: 1,1,2,3,5 ($26.15 in chips) 
Seat 9: Haek82 ($18.90 in chips) 
Seat 10: RUSTY W 2 ($43.75 in chips) 
finztothelft: posts small blind $0.25
peakrnr: posts big blind $0.50
*** HOLE CARDS ***
Dealt to 1,1,2,3,5 [Kh Qd]
1,1,2,3,5: calls $0.50
Haek82: raises $0.50 to $1
RUSTY W 2: folds 
JMAC60: folds 
deepspace68: calls $1
dogbert888: folds 
Deadlydoji: folds 
finztothelft: calls $0.75
peakrnr: calls $0.50
1,1,2,3,5: calls $0.50
*** FLOP *** [5d 6c 7s]
finztothelft: checks 
peakrnr: checks 
1,1,2,3,5: checks 
Haek82: bets $0.50
deepspace68: calls $0.50
finztothelft: calls $0.50
peakrnr: calls $0.50
1,1,2,3,5: folds 
*** TURN *** [5d 6c 7s] [9h]
finztothelft: checks 
peakrnr: checks 
Haek82: bets $1
deepspace68: folds 
finztothelft: folds 
peakrnr: calls $1
*** RIVER *** [5d 6c 7s 9h] [4c]
peakrnr: checks 
Haek82: bets $1
peakrnr: folds 
Haek82 collected $8.60 from pot
*** SUMMARY ***
Total pot $9 | Rake $0.40 
Board [5d 6c 7s 9h 4c]
Seat 1: JMAC60 folded before Flop (didn't bet)
Seat 2: deepspace68 folded on the Turn
Seat 3: dogbert888 folded before Flop (didn't bet)
Seat 4: Deadlydoji (button) folded before Flop (didn't bet)
Seat 6: finztothelft (small blind) folded on the Turn
Seat 7: peakrnr (big blind) folded on the River
Seat 8: 1,1,2,3,5 folded on the Flop
Seat 9: Haek82 collected ($8.60)
Seat 10: RUSTY W 2 folded before Flop (didn't bet)



PokerStars Game #6806677456:  Hold'em Limit ($0.50/$1.00) - 2006/10/28 - 19:35:40 (ET)
Table 'Tanina' 10-max Seat #6 is the button
Seat 1: JMAC60 ($14 in chips) 
Seat 2: deepspace68 ($39.45 in chips) 
Seat 3: dogbert888 ($13.20 in chips) 
Seat 4: Deadlydoji ($19.95 in chips) 
Seat 6: finztothelft ($18 in chips) 
Seat 7: peakrnr ($15.75 in chips) 
Seat 8: 1,1,2,3,5 ($25.15 in chips) 
Seat 9: Haek82 ($25 in chips) 
Seat 10: RUSTY W 2 ($43.75 in chips) 
peakrnr: posts small blind $0.25
1,1,2,3,5: posts big blind $0.50
*** HOLE CARDS ***
Dealt to 1,1,2,3,5 [2d 5h]
Haek82: raises $0.50 to $1
RUSTY W 2: folds 
JMAC60: folds 
deepspace68: folds 
dogbert888 has timed out
dogbert888: folds 
dogbert888 is sitting out
Deadlydoji: raises $0.50 to $1.50
finztothelft: folds 
peakrnr: folds 
1,1,2,3,5: folds 
Haek82: calls $0.50
*** FLOP *** [9s 3h Qc]
Haek82: checks 
Deadlydoji: bets $0.50
Haek82: calls $0.50
*** TURN *** [9s 3h Qc] [7s]
Haek82: checks 
Deadlydoji: bets $1
Haek82: calls $1
*** RIVER *** [9s 3h Qc 7s] [3s]
Haek82: checks 
Deadlydoji: bets $1
Haek82: calls $1
13BD leaves the table
*** SHOW DOWN ***
Deadlydoji: shows [Kc Ks] (two pair, Kings and Threes)
Haek82: mucks hand 
Deadlydoji collected $8.35 from pot
*** SUMMARY ***
Total pot $8.75 | Rake $0.40 
Board [9s 3h Qc 7s 3s]
Seat 1: JMAC60 folded before Flop (didn't bet)
Seat 2: deepspace68 folded before Flop (didn't bet)
Seat 3: dogbert888 folded before Flop (didn't bet)
Seat 4: Deadlydoji showed [Kc Ks] and won ($8.35) with two pair, Kings and Threes
Seat 6: finztothelft (button) folded before Flop (didn't bet)
Seat 7: peakrnr (small blind) folded before Flop
Seat 8: 1,1,2,3,5 (big blind) folded before Flop
Seat 9: Haek82 mucked [Ad Kh]
Seat 10: RUSTY W 2 folded before Flop (didn't bet)



PokerStars Game #6806689278:  Hold'em Limit ($0.50/$1.00) - 2006/10/28 - 19:36:40 (ET)
Table 'Tanina' 10-max Seat #7 is the button
Seat 1: JMAC60 ($14 in chips) 
Seat 2: deepspace68 ($39.45 in chips) 
Seat 4: Deadlydoji ($24.30 in chips) 
Seat 6: finztothelft ($18 in chips) 
Seat 7: peakrnr ($15.50 in chips) 
Seat 8: 1,1,2,3,5 ($24.65 in chips) 
Seat 9: Haek82 ($21 in chips) 
Seat 10: RUSTY W 2 ($43.75 in chips) 
1,1,2,3,5: posts small blind $0.25
Haek82: posts big blind $0.50
*** HOLE CARDS ***
Dealt to 1,1,2,3,5 [2d Qh]
RUSTY W 2: folds 
JMAC60: folds 
dogbert888 has returned
deepspace68: folds 
Deadlydoji: folds 
finztothelft: calls $0.50
rockwhack joins the table at seat #5 
peakrnr: folds 
1,1,2,3,5: folds 
Haek82: checks 
*** FLOP *** [8h 4h 8c]
Haek82: checks 
finztothelft: checks 
*** TURN *** [8h 4h 8c] [8d]
Haek82: checks 
finztothelft: bets $1
Haek82: folds 
finztothelft collected $1.20 from pot
*** SUMMARY ***
Total pot $1.25 | Rake $0.05 
Board [8h 4h 8c 8d]
Seat 1: JMAC60 folded before Flop (didn't bet)
Seat 2: deepspace68 folded before Flop (didn't bet)
Seat 4: Deadlydoji folded before Flop (didn't bet)
Seat 6: finztothelft collected ($1.20)
Seat 7: peakrnr (button) folded before Flop (didn't bet)
Seat 8: 1,1,2,3,5 (small blind) folded before Flop
Seat 9: Haek82 (big blind) folded on the Turn
Seat 10: RUSTY W 2 folded before Flop (didn't bet)



PokerStars Game #6806698442:  Hold'em Limit ($0.50/$1.00) - 2006/10/28 - 19:37:26 (ET)
Table 'Tanina' 10-max Seat #8 is the button
Seat 1: JMAC60 ($14 in chips) 
Seat 2: deepspace68 ($39.45 in chips) 
Seat 3: dogbert888 ($13.20 in chips) 
Seat 4: Deadlydoji ($24.30 in chips) 
Seat 6: finztothelft ($18.70 in chips) 
Seat 7: peakrnr ($15.50 in chips) 
Seat 8: 1,1,2,3,5 ($24.40 in chips) 
Seat 9: Haek82 ($20.50 in chips) 
Seat 10: RUSTY W 2 ($43.75 in chips) 
Haek82: posts small blind $0.25
RUSTY W 2: posts big blind $0.50
rockwhack: sits out 
*** HOLE CARDS ***
Dealt to 1,1,2,3,5 [6s 9c]
JMAC60: folds 
deepspace68: folds 
dogbert888: folds 
Deadlydoji: folds 
finztothelft: calls $0.50
peakrnr: folds 
1,1,2,3,5: folds 
Haek82: calls $0.25
RUSTY W 2: checks 
*** FLOP *** [Ac As Qd]
Haek82: bets $0.50
RUSTY W 2: calls $0.50
finztothelft: folds 
*** TURN *** [Ac As Qd] [7d]
Haek82: bets $1
RUSTY W 2: calls $1
*** RIVER *** [Ac As Qd 7d] [6h]
Haek82: checks 
RUSTY W 2: checks 
*** SHOW DOWN ***
Haek82: shows [Jd Qh] (two pair, Aces and Queens)
RUSTY W 2: mucks hand 
Haek82 collected $4.30 from pot
*** SUMMARY ***
Total pot $4.50 | Rake $0.20 
Board [Ac As Qd 7d 6h]
Seat 1: JMAC60 folded before Flop (didn't bet)
Seat 2: deepspace68 folded before Flop (didn't bet)
Seat 3: dogbert888 folded before Flop (didn't bet)
Seat 4: Deadlydoji folded before Flop (didn't bet)
Seat 6: finztothelft folded on the Flop
Seat 7: peakrnr folded before Flop (didn't bet)
Seat 8: 1,1,2,3,5 (button) folded before Flop (didn't bet)
Seat 9: Haek82 (small blind) showed [Jd Qh] and won ($4.30) with two pair, Aces and Queens
Seat 10: RUSTY W 2 (big blind) mucked [9h Qs]



PokerStars Game #6806707433:  Hold'em Limit ($0.50/$1.00) - 2006/10/28 - 19:38:12 (ET)
Table 'Tanina' 10-max Seat #9 is the button
Seat 1: JMAC60 ($14 in chips) 
Seat 2: deepspace68 ($39.45 in chips) 
Seat 3: dogbert888 ($13.20 in chips) 
Seat 4: Deadlydoji ($24.30 in chips) 
Seat 5: rockwhack ($20 in chips) 
Seat 6: finztothelft ($18.20 in chips) 
Seat 7: peakrnr ($15.50 in chips) 
Seat 8: 1,1,2,3,5 ($24.40 in chips) 
Seat 9: Haek82 ($22.80 in chips) 
Seat 10: RUSTY W 2 ($41.75 in chips) 
RUSTY W 2: posts small blind $0.25
JMAC60: posts big blind $0.50
rockwhack: posts big blind $0.50
*** HOLE CARDS ***
Dealt to 1,1,2,3,5 [9s 3h]
deepspace68: folds 
dogbert888: folds 
Deadlydoji: folds 
rockwhack: checks 
finztothelft: folds 
peakrnr: folds 
1,1,2,3,5: folds 
Haek82: folds 
RUSTY W 2: calls $0.25
JMAC60: checks 
*** FLOP *** [9d 7s 7c]
RUSTY W 2: bets $0.50
JMAC60: folds 
rockwhack: raises $0.50 to $1
RUSTY W 2: folds 
rockwhack collected $2.40 from pot
rockwhack: doesn't show hand 
*** SUMMARY ***
Total pot $2.50 | Rake $0.10 
Board [9d 7s 7c]
Seat 1: JMAC60 (big blind) folded on the Flop
Seat 2: deepspace68 folded before Flop (didn't bet)
Seat 3: dogbert888 folded before Flop (didn't bet)
Seat 4: Deadlydoji folded before Flop (didn't bet)
Seat 5: rockwhack collected ($2.40)
Seat 6: finztothelft folded before Flop (didn't bet)
Seat 7: peakrnr folded before Flop (didn't bet)
Seat 8: 1,1,2,3,5 folded before Flop (didn't bet)
Seat 9: Haek82 (button) folded before Flop (didn't bet)
Seat 10: RUSTY W 2 (small blind) folded on the Flop



PokerStars Game #6806716816:  Hold'em Limit ($0.50/$1.00) - 2006/10/28 - 19:39:01 (ET)
Table 'Tanina' 10-max Seat #10 is the button
Seat 1: JMAC60 ($13.50 in chips) 
Seat 2: deepspace68 ($39.45 in chips) 
Seat 3: dogbert888 ($13.20 in chips) 
Seat 4: Deadlydoji ($24.30 in chips) 
Seat 5: rockwhack ($21.40 in chips) 
Seat 6: finztothelft ($18.20 in chips) 
Seat 7: peakrnr ($15.50 in chips) 
Seat 8: 1,1,2,3,5 ($24.40 in chips) 
Seat 9: Haek82 ($22.80 in chips) 
Seat 10: RUSTY W 2 ($40.75 in chips) 
JMAC60: posts small blind $0.25
deepspace68: posts big blind $0.50
*** HOLE CARDS ***
Dealt to 1,1,2,3,5 [3h 3s]
dogbert888: calls $0.50
Deadlydoji: folds 
rockwhack: calls $0.50
finztothelft: folds 
peakrnr: folds 
1,1,2,3,5: calls $0.50
Haek82: raises $0.50 to $1
RUSTY W 2: folds 
JMAC60: folds 
deepspace68: folds 
dogbert888: calls $0.50
rockwhack: calls $0.50
1,1,2,3,5: calls $0.50
*** FLOP *** [Ah Kc Td]
dogbert888: checks 
rockwhack: checks 
1,1,2,3,5: checks 
Haek82: bets $0.50
dogbert888: folds 
rockwhack: calls $0.50
1,1,2,3,5: folds 
*** TURN *** [Ah Kc Td] [Th]
rockwhack: checks 
Haek82: checks 
*** RIVER *** [Ah Kc Td Th] [9s]
rockwhack: bets $1
Haek82: calls $1
*** SHOW DOWN ***
rockwhack: shows [Ad 8d] (two pair, Aces and Tens)
Haek82: mucks hand 
rockwhack collected $7.40 from pot
*** SUMMARY ***
Total pot $7.75 | Rake $0.35 
Board [Ah Kc Td Th 9s]
Seat 1: JMAC60 (small blind) folded before Flop
Seat 2: deepspace68 (big blind) folded before Flop
Seat 3: dogbert888 folded on the Flop
Seat 4: Deadlydoji folded before Flop (didn't bet)
Seat 5: rockwhack showed [Ad 8d] and won ($7.40) with two pair, Aces and Tens
Seat 6: finztothelft folded before Flop (didn't bet)
Seat 7: peakrnr folded before Flop (didn't bet)
Seat 8: 1,1,2,3,5 folded on the Flop
Seat 9: Haek82 mucked [Kd Qd]
Seat 10: RUSTY W 2 (button) folded before Flop (didn't bet)



PokerStars Game #6806728394:  Hold'em Limit ($0.50/$1.00) - 2006/10/28 - 19:40:01 (ET)
Table 'Tanina' 10-max Seat #1 is the button
Seat 1: JMAC60 ($13.25 in chips) 
Seat 2: deepspace68 ($38.95 in chips) 
Seat 3: dogbert888 ($12.20 in chips) 
Seat 4: Deadlydoji ($24.30 in chips) 
Seat 5: rockwhack ($26.30 in chips) 
Seat 6: finztothelft ($18.20 in chips) 
Seat 7: peakrnr ($15.50 in chips) 
Seat 8: 1,1,2,3,5 ($23.40 in chips) 
Seat 9: Haek82 ($20.30 in chips) 
Seat 10: RUSTY W 2 ($40.75 in chips) 
deepspace68: posts small blind $0.25
dogbert888: posts big blind $0.50
*** HOLE CARDS ***
Dealt to 1,1,2,3,5 [2s 3s]
Deadlydoji: folds 
rockwhack: folds 
finztothelft: folds 
peakrnr: calls $0.50
1,1,2,3,5: folds 
Haek82: folds 
RUSTY W 2: folds 
JMAC60: calls $0.50
deepspace68: calls $0.25
dogbert888: raises $0.50 to $1
peakrnr: calls $0.50
JMAC60: calls $0.50
deepspace68: folds 
*** FLOP *** [7s 9c 9s]
dogbert888: bets $0.50
peakrnr: folds 
JMAC60: folds 
dogbert888 collected $3.35 from pot
*** SUMMARY ***
Total pot $3.50 | Rake $0.15 
Board [7s 9c 9s]
Seat 1: JMAC60 (button) folded on the Flop
Seat 2: deepspace68 (small blind) folded before Flop
Seat 3: dogbert888 (big blind) collected ($3.35)
Seat 4: Deadlydoji folded before Flop (didn't bet)
Seat 5: rockwhack folded before Flop (didn't bet)
Seat 6: finztothelft folded before Flop (didn't bet)
Seat 7: peakrnr folded on the Flop
Seat 8: 1,1,2,3,5 folded before Flop (didn't bet)
Seat 9: Haek82 folded before Flop (didn't bet)
Seat 10: RUSTY W 2 folded before Flop (didn't bet)



PokerStars Game #6806739934:  Hold'em Limit ($0.50/$1.00) - 2006/10/28 - 19:41:00 (ET)
Table 'Tanina' 10-max Seat #2 is the button
Seat 1: JMAC60 ($12.25 in chips) 
Seat 2: deepspace68 ($38.45 in chips) 
Seat 3: dogbert888 ($14.55 in chips) 
Seat 4: Deadlydoji ($24.30 in chips) 
Seat 5: rockwhack ($26.30 in chips) 
Seat 6: finztothelft ($18.20 in chips) 
Seat 7: peakrnr ($14.50 in chips) 
Seat 8: 1,1,2,3,5 ($23.40 in chips) 
Seat 9: Haek82 ($20.30 in chips) 
Seat 10: RUSTY W 2 ($40.75 in chips) 
dogbert888: posts small blind $0.25
Deadlydoji: posts big blind $0.50
*** HOLE CARDS ***
Dealt to 1,1,2,3,5 [5h 3s]
rockwhack: folds 
finztothelft: folds 
peakrnr: folds 
1,1,2,3,5: folds 
Haek82: folds 
RUSTY W 2: calls $0.50
JMAC60: folds 
deepspace68: folds 
dogbert888: folds 
Deadlydoji: checks 
*** FLOP *** [Qc Kh 4h]
Deadlydoji: checks 
RUSTY W 2: bets $0.50
Deadlydoji: folds 
RUSTY W 2 collected $1.20 from pot
*** SUMMARY ***
Total pot $1.25 | Rake $0.05 
Board [Qc Kh 4h]
Seat 1: JMAC60 folded before Flop (didn't bet)
Seat 2: deepspace68 (button) folded before Flop (didn't bet)
Seat 3: dogbert888 (small blind) folded before Flop
Seat 4: Deadlydoji (big blind) folded on the Flop
Seat 5: rockwhack folded before Flop (didn't bet)
Seat 6: finztothelft folded before Flop (didn't bet)
Seat 7: peakrnr folded before Flop (didn't bet)
Seat 8: 1,1,2,3,5 folded before Flop (didn't bet)
Seat 9: Haek82 folded before Flop (didn't bet)
Seat 10: RUSTY W 2 collected ($1.20)



PokerStars Game #6806747250:  Hold'em Limit ($0.50/$1.00) - 2006/10/28 - 19:41:38 (ET)
Table 'Tanina' 10-max Seat #3 is the button
Seat 1: JMAC60 ($12.25 in chips) 
Seat 2: deepspace68 ($38.45 in chips) 
Seat 3: dogbert888 ($14.30 in chips) 
Seat 4: Deadlydoji ($23.80 in chips) 
Seat 5: rockwhack ($26.30 in chips) 
Seat 6: finztothelft ($18.20 in chips) 
Seat 7: peakrnr ($14.50 in chips) 
Seat 8: 1,1,2,3,5 ($23.40 in chips) 
Seat 9: Haek82 ($20.30 in chips) 
Seat 10: RUSTY W 2 ($41.45 in chips) 
Deadlydoji: posts small blind $0.25
rockwhack: posts big blind $0.50
*** HOLE CARDS ***
Dealt to 1,1,2,3,5 [Qs 9h]
finztothelft: folds 
peakrnr: folds 
1,1,2,3,5: folds 
Haek82: folds 
RUSTY W 2: calls $0.50
JMAC60: folds 
deepspace68: calls $0.50
dogbert888: folds 
Deadlydoji: folds 
rockwhack: checks 
*** FLOP *** [Ad 4d Ah]
rockwhack: checks 
RUSTY W 2: checks 
deepspace68: bets $0.50
rockwhack: folds 
RUSTY W 2: calls $0.50
*** TURN *** [Ad 4d Ah] [Ac]
RUSTY W 2: bets $1
deepspace68: calls $1
*** RIVER *** [Ad 4d Ah Ac] [8h]
RUSTY W 2: bets $1
deepspace68: calls $1
*** SHOW DOWN ***
RUSTY W 2: shows [Qd 2d] (three of a kind, Aces)
deepspace68: shows [Kd Jh] (three of a kind, Aces - King kicker)
deepspace68 collected $6.45 from pot
*** SUMMARY ***
Total pot $6.75 | Rake $0.30 
Board [Ad 4d Ah Ac 8h]
Seat 1: JMAC60 folded before Flop (didn't bet)
Seat 2: deepspace68 showed [Kd Jh] and won ($6.45) with three of a kind, Aces
Seat 3: dogbert888 (button) folded before Flop (didn't bet)
Seat 4: Deadlydoji (small blind) folded before Flop
Seat 5: rockwhack (big blind) folded on the Flop
Seat 6: finztothelft folded before Flop (didn't bet)
Seat 7: peakrnr folded before Flop (didn't bet)
Seat 8: 1,1,2,3,5 folded before Flop (didn't bet)
Seat 9: Haek82 folded before Flop (didn't bet)
Seat 10: RUSTY W 2 showed [Qd 2d] and lost with three of a kind, Aces



PokerStars Game #6806755714:  Hold'em Limit ($0.50/$1.00) - 2006/10/28 - 19:42:22 (ET)
Table 'Tanina' 10-max Seat #4 is the button
Seat 1: JMAC60 ($12.25 in chips) 
Seat 2: deepspace68 ($41.90 in chips) 
Seat 3: dogbert888 ($14.30 in chips) 
Seat 4: Deadlydoji ($23.55 in chips) 
Seat 5: rockwhack ($25.80 in chips) 
Seat 6: finztothelft ($18.20 in chips) 
Seat 7: peakrnr ($14.50 in chips) 
Seat 8: 1,1,2,3,5 ($23.40 in chips) 
Seat 9: Haek82 ($20.30 in chips) 
Seat 10: RUSTY W 2 ($38.45 in chips) 
rockwhack: posts small blind $0.25
finztothelft: posts big blind $0.50
*** HOLE CARDS ***
Dealt to 1,1,2,3,5 [Tc Ts]
peakrnr: folds 
1,1,2,3,5: raises $0.50 to $1
Haek82: calls $1
RUSTY W 2: folds 
JMAC60: folds 
deepspace68: folds 
dogbert888: folds 
Deadlydoji: folds 
rockwhack: raises $0.50 to $1.50
finztothelft: folds 
1,1,2,3,5: calls $0.50
Haek82: calls $0.50
*** FLOP *** [5d 7s As]
rockwhack: bets $0.50
1,1,2,3,5: calls $0.50
Haek82: calls $0.50
*** TURN *** [5d 7s As] [8h]
rockwhack: checks 
1,1,2,3,5: checks 
Haek82: checks 
*** RIVER *** [5d 7s As 8h] [2d]
rockwhack: bets $1
1,1,2,3,5: folds 
Haek82: calls $1
*** SHOW DOWN ***
rockwhack: shows [Qh Qs] (a pair of Queens)
Haek82: shows [Js Ad] (a pair of Aces)
Haek82 collected $8.10 from pot
*** SUMMARY ***
Total pot $8.50 | Rake $0.40 
Board [5d 7s As 8h 2d]
Seat 1: JMAC60 folded before Flop (didn't bet)
Seat 2: deepspace68 folded before Flop (didn't bet)
Seat 3: dogbert888 folded before Flop (didn't bet)
Seat 4: Deadlydoji (button) folded before Flop (didn't bet)
Seat 5: rockwhack (small blind) showed [Qh Qs] and lost with a pair of Queens
Seat 6: finztothelft (big blind) folded before Flop
Seat 7: peakrnr folded before Flop (didn't bet)
Seat 8: 1,1,2,3,5 folded on the River
Seat 9: Haek82 showed [Js Ad] and won ($8.10) with a pair of Aces
Seat 10: RUSTY W 2 folded before Flop (didn't bet)



PokerStars Game #6806763770:  Hold'em Limit ($0.50/$1.00) - 2006/10/28 - 19:43:04 (ET)
Table 'Tanina' 10-max Seat #5 is the button
Seat 1: JMAC60 ($12.25 in chips) 
Seat 2: deepspace68 ($41.90 in chips) 
Seat 3: dogbert888 ($14.30 in chips) 
Seat 4: Deadlydoji ($23.55 in chips) 
Seat 5: rockwhack ($22.80 in chips) 
Seat 6: finztothelft ($17.70 in chips) 
Seat 7: peakrnr ($14.50 in chips) 
Seat 8: 1,1,2,3,5 ($21.40 in chips) 
Seat 9: Haek82 ($25.40 in chips) 
Seat 10: RUSTY W 2 ($38.45 in chips) 
finztothelft: posts small blind $0.25
peakrnr: posts big blind $0.50
*** HOLE CARDS ***
Dealt to 1,1,2,3,5 [Jh 5h]
1,1,2,3,5: folds 
Haek82: folds 
RUSTY W 2: folds 
JMAC60: folds 
deepspace68: folds 
dogbert888: folds 
Deadlydoji: folds 
rockwhack: folds 
finztothelft: calls $0.25
peakrnr: checks 
*** FLOP *** [4d 8d 5c]
finztothelft: bets $0.50
peakrnr: folds 
finztothelft collected $0.95 from pot
*** SUMMARY ***
Total pot $1 | Rake $0.05 
Board [4d 8d 5c]
Seat 1: JMAC60 folded before Flop (didn't bet)
Seat 2: deepspace68 folded before Flop (didn't bet)
Seat 3: dogbert888 folded before Flop (didn't bet)
Seat 4: Deadlydoji folded before Flop (didn't bet)
Seat 5: rockwhack (button) folded before Flop (didn't bet)
Seat 6: finztothelft (small blind) collected ($0.95)
Seat 7: peakrnr (big blind) folded on the Flop
Seat 8: 1,1,2,3,5 folded before Flop (didn't bet)
Seat 9: Haek82 folded before Flop (didn't bet)
Seat 10: RUSTY W 2 folded before Flop (didn't bet)



PokerStars Game #6806769883:  Hold'em Limit ($0.50/$1.00) - 2006/10/28 - 19:43:35 (ET)
Table 'Tanina' 10-max Seat #6 is the button
Seat 1: JMAC60 ($12.25 in chips) 
Seat 2: deepspace68 ($41.90 in chips) 
Seat 3: dogbert888 ($14.30 in chips) 
Seat 4: Deadlydoji ($23.55 in chips) 
Seat 5: rockwhack ($22.80 in chips) 
Seat 6: finztothelft ($18.15 in chips) 
Seat 7: peakrnr ($14 in chips) 
Seat 8: 1,1,2,3,5 ($21.40 in chips) 
Seat 9: Haek82 ($25.40 in chips) 
Seat 10: RUSTY W 2 ($38.45 in chips) 
peakrnr: posts small blind $0.25
1,1,2,3,5: posts big blind $0.50
*** HOLE CARDS ***
Dealt to 1,1,2,3,5 [8s 2d]
Haek82: folds 
RUSTY W 2: calls $0.50
JMAC60: folds 
deepspace68: folds 
dogbert888: folds 
Deadlydoji: folds 
rockwhack: calls $0.50
finztothelft: calls $0.50
peakrnr: calls $0.25
1,1,2,3,5: checks 
*** FLOP *** [7c 8h Jc]
peakrnr: checks 
1,1,2,3,5: checks 
RUSTY W 2: checks 
rockwhack: bets $0.50
finztothelft: calls $0.50
peakrnr: folds 
1,1,2,3,5: folds 
RUSTY W 2: calls $0.50
*** TURN *** [7c 8h Jc] [Qd]
RUSTY W 2: checks 
rockwhack: bets $1
finztothelft: folds 
RUSTY W 2: calls $1
*** RIVER *** [7c 8h Jc Qd] [9c]
RUSTY W 2: bets $1
rockwhack: calls $1
*** SHOW DOWN ***
RUSTY W 2: shows [5h 6h] (a straight, Five to Nine)
rockwhack: mucks hand 
RUSTY W 2 collected $7.65 from pot
*** SUMMARY ***
Total pot $8 | Rake $0.35 
Board [7c 8h Jc Qd 9c]
Seat 1: JMAC60 folded before Flop (didn't bet)
Seat 2: deepspace68 folded before Flop (didn't bet)
Seat 3: dogbert888 folded before Flop (didn't bet)
Seat 4: Deadlydoji folded before Flop (didn't bet)
Seat 5: rockwhack mucked [9s 8d]
Seat 6: finztothelft (button) folded on the Turn
Seat 7: peakrnr (small blind) folded on the Flop
Seat 8: 1,1,2,3,5 (big blind) folded on the Flop
Seat 9: Haek82 folded before Flop (didn't bet)
Seat 10: RUSTY W 2 showed [5h 6h] and won ($7.65) with a straight, Five to Nine



PokerStars Game #6806782759:  Hold'em Limit ($0.50/$1.00) - 2006/10/28 - 19:44:43 (ET)
Table 'Tanina' 10-max Seat #7 is the button
Seat 1: JMAC60 ($12.25 in chips) 
Seat 2: deepspace68 ($41.90 in chips) 
Seat 3: dogbert888 ($14.30 in chips) 
Seat 4: Deadlydoji ($23.55 in chips) 
Seat 5: rockwhack ($19.80 in chips) 
Seat 6: finztothelft ($17.15 in chips) 
Seat 7: peakrnr ($13.50 in chips) 
Seat 8: 1,1,2,3,5 ($20.90 in chips) 
Seat 9: Haek82 ($25.40 in chips) 
Seat 10: RUSTY W 2 ($43.10 in chips) 
1,1,2,3,5: posts small blind $0.25
Haek82: posts big blind $0.50
*** HOLE CARDS ***
Dealt to 1,1,2,3,5 [9h 9d]
RUSTY W 2: folds 
JMAC60: folds 
deepspace68: folds 
dogbert888: calls $0.50
Deadlydoji: folds 
rockwhack: raises $0.50 to $1
finztothelft: folds 
peakrnr: folds 
1,1,2,3,5: folds 
Haek82: folds 
dogbert888: calls $0.50
*** FLOP *** [9s Js 7s]
dogbert888: bets $0.50
rockwhack: raises $0.50 to $1
dogbert888: calls $0.50
*** TURN *** [9s Js 7s] [6c]
dogbert888: checks 
rockwhack: bets $1
dogbert888: calls $1
*** RIVER *** [9s Js 7s 6c] [2d]
dogbert888: checks 
rockwhack: bets $1
dogbert888: folds 
rockwhack collected $6.45 from pot
*** SUMMARY ***
Total pot $6.75 | Rake $0.30 
Board [9s Js 7s 6c 2d]
Seat 1: JMAC60 folded before Flop (didn't bet)
Seat 2: deepspace68 folded before Flop (didn't bet)
Seat 3: dogbert888 folded on the River
Seat 4: Deadlydoji folded before Flop (didn't bet)
Seat 5: rockwhack collected ($6.45)
Seat 6: finztothelft folded before Flop (didn't bet)
Seat 7: peakrnr (button) folded before Flop (didn't bet)
Seat 8: 1,1,2,3,5 (small blind) folded before Flop
Seat 9: Haek82 (big blind) folded before Flop
Seat 10: RUSTY W 2 folded before Flop (didn't bet)



PokerStars Game #6806792112:  Hold'em Limit ($0.50/$1.00) - 2006/10/28 - 19:45:30 (ET)
Table 'Tanina' 10-max Seat #8 is the button
Seat 1: JMAC60 ($12.25 in chips) 
Seat 2: deepspace68 ($41.90 in chips) 
Seat 3: dogbert888 ($11.30 in chips) 
Seat 4: Deadlydoji ($23.55 in chips) 
Seat 5: rockwhack ($23.25 in chips) 
Seat 6: finztothelft ($17.15 in chips) 
Seat 7: peakrnr ($13.50 in chips) 
Seat 8: 1,1,2,3,5 ($20.65 in chips) 
Seat 9: Haek82 ($24.90 in chips) 
Seat 10: RUSTY W 2 ($43.10 in chips) 
Haek82: posts small blind $0.25
RUSTY W 2: posts big blind $0.50
*** HOLE CARDS ***
Dealt to 1,1,2,3,5 [8d Jh]
JMAC60: folds 
deepspace68: folds 
dogbert888: raises $0.50 to $1
Deadlydoji: folds 
rockwhack: folds 
finztothelft: folds 
peakrnr: folds 
1,1,2,3,5: folds 
Haek82: folds 
RUSTY W 2: folds 
dogbert888 collected $1.25 from pot
*** SUMMARY ***
Total pot $1.25 | Rake $0 
Seat 1: JMAC60 folded before Flop (didn't bet)
Seat 2: deepspace68 folded before Flop (didn't bet)
Seat 3: dogbert888 collected ($1.25)
Seat 4: Deadlydoji folded before Flop (didn't bet)
Seat 5: rockwhack folded before Flop (didn't bet)
Seat 6: finztothelft folded before Flop (didn't bet)
Seat 7: peakrnr folded before Flop (didn't bet)
Seat 8: 1,1,2,3,5 (button) folded before Flop (didn't bet)
Seat 9: Haek82 (small blind) folded before Flop
Seat 10: RUSTY W 2 (big blind) folded before Flop



PokerStars Game #6806798425:  Hold'em Limit ($0.50/$1.00) - 2006/10/28 - 19:46:03 (ET)
Table 'Tanina' 10-max Seat #9 is the button
Seat 1: JMAC60 ($12.25 in chips) 
Seat 2: deepspace68 ($41.90 in chips) 
Seat 3: dogbert888 ($12.05 in chips) 
Seat 4: Deadlydoji ($23.55 in chips) 
Seat 5: rockwhack ($23.25 in chips) 
Seat 6: finztothelft ($17.15 in chips) 
Seat 7: peakrnr ($13.50 in chips) 
Seat 8: 1,1,2,3,5 ($20.65 in chips) 
Seat 9: Haek82 ($24.65 in chips) 
Seat 10: RUSTY W 2 ($42.60 in chips) 
RUSTY W 2: posts small blind $0.25
JMAC60: posts big blind $0.50
*** HOLE CARDS ***
Dealt to 1,1,2,3,5 [6h 6d]
deepspace68: calls $0.50
dogbert888: folds 
Deadlydoji: folds 
rockwhack: folds 
finztothelft: folds 
peakrnr: folds 
1,1,2,3,5: calls $0.50
Haek82: folds 
RUSTY W 2: calls $0.25
JMAC60: checks 
*** FLOP *** [7h 7s Jh]
RUSTY W 2: checks 
JMAC60: checks 
deepspace68: bets $0.50
1,1,2,3,5: calls $0.50
RUSTY W 2: folds 
JMAC60: folds 
*** TURN *** [7h 7s Jh] [Jd]
deepspace68: checks 
1,1,2,3,5: bets $1
deepspace68: folds 
1,1,2,3,5 collected $2.90 from pot
1,1,2,3,5: doesn't show hand 
*** SUMMARY ***
Total pot $3 | Rake $0.10 
Board [7h 7s Jh Jd]
Seat 1: JMAC60 (big blind) folded on the Flop
Seat 2: deepspace68 folded on the Turn
Seat 3: dogbert888 folded before Flop (didn't bet)
Seat 4: Deadlydoji folded before Flop (didn't bet)
Seat 5: rockwhack folded before Flop (didn't bet)
Seat 6: finztothelft folded before Flop (didn't bet)
Seat 7: peakrnr folded before Flop (didn't bet)
Seat 8: 1,1,2,3,5 collected ($2.90)
Seat 9: Haek82 (button) folded before Flop (didn't bet)
Seat 10: RUSTY W 2 (small blind) folded on the Flop



PokerStars Game #6806810121:  Hold'em Limit ($0.50/$1.00) - 2006/10/28 - 19:47:03 (ET)
Table 'Tanina' 10-max Seat #10 is the button
Seat 1: JMAC60 ($11.75 in chips) 
Seat 2: deepspace68 ($40.90 in chips) 
Seat 3: dogbert888 ($12.05 in chips) 
Seat 4: Deadlydoji ($23.55 in chips) 
Seat 5: rockwhack ($23.25 in chips) 
Seat 6: finztothelft ($17.15 in chips) 
Seat 7: peakrnr ($13.50 in chips) 
Seat 8: 1,1,2,3,5 ($22.55 in chips) 
Seat 9: Haek82 ($24.65 in chips) 
Seat 10: RUSTY W 2 ($42.10 in chips) 
JMAC60: posts small blind $0.25
deepspace68: posts big blind $0.50
*** HOLE CARDS ***
Dealt to 1,1,2,3,5 [Kc 7d]
dogbert888: folds 
dogbert888 leaves the table
Deadlydoji: folds 
rockwhack: folds 
finztothelft: folds 
peakrnr: raises $0.50 to $1
1,1,2,3,5: folds 
Haek82: folds 
RUSTY W 2: calls $1
JMAC60: folds 
deepspace68: calls $0.50
*** FLOP *** [8c 2c 6d]
deepspace68: checks 
peakrnr: checks 
RUSTY W 2: bets $0.50
deepspace68: folds 
peakrnr: calls $0.50
*** TURN *** [8c 2c 6d] [Ad]
peakrnr: bets $1
RUSTY W 2: raises $1 to $2
peakrnr: calls $1
*** RIVER *** [8c 2c 6d Ad] [3c]
YATAHA740 joins the table at seat #3 
peakrnr: bets $1
RUSTY W 2: calls $1
*** SHOW DOWN ***
peakrnr: shows [Tc Ac] (a flush, Ace high)
RUSTY W 2: mucks hand 
peakrnr collected $9.80 from pot
*** SUMMARY ***
Total pot $10.25 | Rake $0.45 
Board [8c 2c 6d Ad 3c]
Seat 1: JMAC60 (small blind) folded before Flop
Seat 2: deepspace68 (big blind) folded on the Flop
Seat 3: dogbert888 folded before Flop (didn't bet)
Seat 4: Deadlydoji folded before Flop (didn't bet)
Seat 5: rockwhack folded before Flop (didn't bet)
Seat 6: finztothelft folded before Flop (didn't bet)
Seat 7: peakrnr showed [Tc Ac] and won ($9.80) with a flush, Ace high
Seat 8: 1,1,2,3,5 folded before Flop (didn't bet)
Seat 9: Haek82 folded before Flop (didn't bet)
Seat 10: RUSTY W 2 (button) mucked [8h 6h]



PokerStars Game #6806825667:  Hold'em Limit ($0.50/$1.00) - 2006/10/28 - 19:48:23 (ET)
Table 'Tanina' 10-max Seat #1 is the button
Seat 1: JMAC60 ($11.50 in chips) 
Seat 2: deepspace68 ($39.90 in chips) 
Seat 3: YATAHA740 ($20 in chips) 
Seat 4: Deadlydoji ($23.55 in chips) 
Seat 5: rockwhack ($23.25 in chips) 
Seat 6: finztothelft ($17.15 in chips) 
Seat 7: peakrnr ($18.80 in chips) 
Seat 8: 1,1,2,3,5 ($22.55 in chips) 
Seat 9: Haek82 ($24.65 in chips) 
Seat 10: RUSTY W 2 ($37.60 in chips) 
deepspace68: posts small blind $0.25
YATAHA740: posts big blind $0.50
*** HOLE CARDS ***
Dealt to 1,1,2,3,5 [8s 4s]
Deadlydoji: folds 
rockwhack: calls $0.50
finztothelft: folds 
peakrnr: folds 
1,1,2,3,5: folds 
Haek82: calls $0.50
RUSTY W 2: calls $0.50
JMAC60: folds 
deepspace68: folds 
YATAHA740: checks 
*** FLOP *** [2s 2d Kc]
YATAHA740: checks 
rockwhack: bets $0.50
Haek82: calls $0.50
RUSTY W 2: folds 
YATAHA740: folds 
*** TURN *** [2s 2d Kc] [7d]
rockwhack: bets $1
Haek82: folds 
rockwhack collected $3.10 from pot
*** SUMMARY ***
Total pot $3.25 | Rake $0.15 
Board [2s 2d Kc 7d]
Seat 1: JMAC60 (button) folded before Flop (didn't bet)
Seat 2: deepspace68 (small blind) folded before Flop
Seat 3: YATAHA740 (big blind) folded on the Flop
Seat 4: Deadlydoji folded before Flop (didn't bet)
Seat 5: rockwhack collected ($3.10)
Seat 6: finztothelft folded before Flop (didn't bet)
Seat 7: peakrnr folded before Flop (didn't bet)
Seat 8: 1,1,2,3,5 folded before Flop (didn't bet)
Seat 9: Haek82 folded on the Turn
Seat 10: RUSTY W 2 folded on the Flop



PokerStars Game #6806833628:  Hold'em Limit ($0.50/$1.00) - 2006/10/28 - 19:49:04 (ET)
Table 'Tanina' 10-max Seat #2 is the button
Seat 1: JMAC60 ($11.50 in chips) 
Seat 2: deepspace68 ($39.65 in chips) 
Seat 3: YATAHA740 ($19.50 in chips) 
Seat 5: rockwhack ($25.35 in chips) 
Seat 6: finztothelft ($17.15 in chips) 
Seat 7: peakrnr ($18.80 in chips) 
Seat 8: 1,1,2,3,5 ($22.55 in chips) 
Seat 9: Haek82 ($23.65 in chips) 
Seat 10: RUSTY W 2 ($37.10 in chips) 
YATAHA740: posts small blind $0.25
Deadlydoji: is sitting out 
rockwhack: posts big blind $0.50
*** HOLE CARDS ***
Dealt to 1,1,2,3,5 [7d 3s]
finztothelft: folds 
peakrnr: raises $0.50 to $1
1,1,2,3,5: folds 
Haek82: calls $1
RUSTY W 2: calls $1
JMAC60: folds 
deepspace68: calls $1
YATAHA740: folds 
rockwhack: folds 
*** FLOP *** [4c 9d 8h]
peakrnr: bets $0.50
Haek82: folds 
RUSTY W 2: calls $0.50
deepspace68: calls $0.50
*** TURN *** [4c 9d 8h] [As]
peakrnr: bets $1
Deadlydoji has returned
RUSTY W 2: calls $1
deepspace68: folds 
*** RIVER *** [4c 9d 8h As] [3c]
peakrnr: bets $1
Deadlydoji leaves the table
RUSTY W 2: calls $1
*** SHOW DOWN ***
peakrnr: shows [Ah Ad] (three of a kind, Aces)
RUSTY W 2: mucks hand 
peakrnr collected $9.80 from pot
*** SUMMARY ***
Total pot $10.25 | Rake $0.45 
Board [4c 9d 8h As 3c]
Seat 1: JMAC60 folded before Flop (didn't bet)
Seat 2: deepspace68 (button) folded on the Turn
Seat 3: YATAHA740 (small blind) folded before Flop
Seat 5: rockwhack (big blind) folded before Flop
Seat 6: finztothelft folded before Flop (didn't bet)
Seat 7: peakrnr showed [Ah Ad] and won ($9.80) with three of a kind, Aces
Seat 8: 1,1,2,3,5 folded before Flop (didn't bet)
Seat 9: Haek82 folded on the Flop
Seat 10: RUSTY W 2 mucked [9c Jc]



PokerStars Game #6806843932:  Hold'em Limit ($0.50/$1.00) - 2006/10/28 - 19:49:58 (ET)
Table 'Tanina' 10-max Seat #3 is the button
Seat 1: JMAC60 ($11.50 in chips) 
Seat 2: deepspace68 ($38.15 in chips) 
Seat 3: YATAHA740 ($19.25 in chips) 
Seat 5: rockwhack ($24.85 in chips) 
Seat 6: finztothelft ($17.15 in chips) 
Seat 7: peakrnr ($25.10 in chips) 
Seat 8: 1,1,2,3,5 ($22.55 in chips) 
Seat 9: Haek82 ($22.65 in chips) 
Seat 10: RUSTY W 2 ($33.60 in chips) 
rockwhack: posts small blind $0.25
finztothelft: posts big blind $0.50
*** HOLE CARDS ***
Dealt to 1,1,2,3,5 [4d 8d]
peakrnr: folds 
1,1,2,3,5: folds 
Haek82: folds 
RUSTY W 2: folds 
JMAC60: raises $0.50 to $1
deepspace68: folds 
YATAHA740: folds 
rockwhack: folds 
finztothelft: calls $0.50
*** FLOP *** [8s As 6d]
peakrnr leaves the table
finztothelft: checks 
JMAC60: bets $0.50
finztothelft: folds 
JMAC60 collected $2.15 from pot
JMAC60: doesn't show hand 
*** SUMMARY ***
Total pot $2.25 | Rake $0.10 
Board [8s As 6d]
Seat 1: JMAC60 collected ($2.15)
Seat 2: deepspace68 folded before Flop (didn't bet)
Seat 3: YATAHA740 (button) folded before Flop (didn't bet)
Seat 5: rockwhack (small blind) folded before Flop
Seat 6: finztothelft (big blind) folded on the Flop
Seat 7: peakrnr folded before Flop (didn't bet)
Seat 8: 1,1,2,3,5 folded before Flop (didn't bet)
Seat 9: Haek82 folded before Flop (didn't bet)
Seat 10: RUSTY W 2 folded before Flop (didn't bet)



PokerStars Game #6806850249:  Hold'em Limit ($0.50/$1.00) - 2006/10/28 - 19:50:31 (ET)
Table 'Tanina' 10-max Seat #5 is the button
Seat 1: JMAC60 ($12.65 in chips) 
Seat 2: deepspace68 ($38.15 in chips) 
Seat 3: YATAHA740 ($19.25 in chips) 
Seat 5: rockwhack ($24.60 in chips) 
Seat 6: finztothelft ($16.15 in chips) 
Seat 8: 1,1,2,3,5 ($22.55 in chips) 
Seat 9: Haek82 ($22.65 in chips) 
Seat 10: RUSTY W 2 ($33.60 in chips) 
finztothelft: posts small blind $0.25
1,1,2,3,5: posts big blind $0.50
*** HOLE CARDS ***
Dealt to 1,1,2,3,5 [6h 5c]
Haek82: calls $0.50
RUSTY W 2: calls $0.50
JMAC60: folds 
deepspace68: folds 
YATAHA740: folds 
rockwhack: folds 
UncHerb38 joins the table at seat #7 
finztothelft: calls $0.25
1,1,2,3,5: checks 
*** FLOP *** [Jc Ah 8h]
finztothelft: checks 
1,1,2,3,5: checks 
Haek82: checks 
RUSTY W 2: checks 
*** TURN *** [Jc Ah 8h] [Js]
finztothelft: checks 
1,1,2,3,5: checks 
Haek82: bets $1
RUSTY W 2: folds 
finztothelft: folds 
1,1,2,3,5: folds 
Haek82 collected $1.90 from pot
*** SUMMARY ***
Total pot $2 | Rake $0.10 
Board [Jc Ah 8h Js]
Seat 1: JMAC60 folded before Flop (didn't bet)
Seat 2: deepspace68 folded before Flop (didn't bet)
Seat 3: YATAHA740 folded before Flop (didn't bet)
Seat 5: rockwhack (button) folded before Flop (didn't bet)
Seat 6: finztothelft (small blind) folded on the Turn
Seat 8: 1,1,2,3,5 (big blind) folded on the Turn
Seat 9: Haek82 collected ($1.90)
Seat 10: RUSTY W 2 folded on the Turn



PokerStars Game #6806859084:  Hold'em Limit ($0.50/$1.00) - 2006/10/28 - 19:51:16 (ET)
Table 'Tanina' 10-max Seat #6 is the button
Seat 1: JMAC60 ($12.65 in chips) 
Seat 2: deepspace68 ($38.15 in chips) 
Seat 3: YATAHA740 ($19.25 in chips) 
Seat 5: rockwhack ($24.60 in chips) 
Seat 6: finztothelft ($15.65 in chips) 
Seat 8: 1,1,2,3,5 ($22.05 in chips) 
Seat 9: Haek82 ($24.05 in chips) 
Seat 10: RUSTY W 2 ($33.10 in chips) 
UncHerb38 will be allowed to play after the button
1,1,2,3,5: posts small blind $0.25
Haek82: posts big blind $0.50
*** HOLE CARDS ***
Dealt to 1,1,2,3,5 [9c 5h]
RUSTY W 2: folds 
JMAC60: folds 
deepspace68: folds 
YATAHA740: folds 
rockwhack: folds 
finztothelft: folds 
1,1,2,3,5: folds 
Haek82 collected $0.50 from pot
*** SUMMARY ***
Total pot $0.50 | Rake $0 
Seat 1: JMAC60 folded before Flop (didn't bet)
Seat 2: deepspace68 folded before Flop (didn't bet)
Seat 3: YATAHA740 folded before Flop (didn't bet)
Seat 5: rockwhack folded before Flop (didn't bet)
Seat 6: finztothelft (button) folded before Flop (didn't bet)
Seat 8: 1,1,2,3,5 (small blind) folded before Flop
Seat 9: Haek82 (big blind) collected ($0.50)
Seat 10: RUSTY W 2 folded before Flop (didn't bet)



PokerStars Game #6806863635:  Hold'em Limit ($0.50/$1.00) - 2006/10/28 - 19:51:40 (ET)
Table 'Tanina' 10-max Seat #8 is the button
Seat 1: JMAC60 ($12.65 in chips) 
Seat 2: deepspace68 ($38.15 in chips) 
Seat 3: YATAHA740 ($19.25 in chips) 
Seat 5: rockwhack ($24.60 in chips) 
Seat 6: finztothelft ($15.65 in chips) 
Seat 8: 1,1,2,3,5 ($21.80 in chips) 
Seat 9: Haek82 ($24.30 in chips) 
Seat 10: RUSTY W 2 ($33.10 in chips) 
Haek82: posts small blind $0.25
RUSTY W 2: posts big blind $0.50
UncHerb38: sits out 
*** HOLE CARDS ***
Dealt to 1,1,2,3,5 [Jh 3d]
JMAC60: folds 
deepspace68: raises $0.50 to $1
YATAHA740: folds 
rockwhack: folds 
finztothelft: folds 
1,1,2,3,5: folds 
Haek82: calls $0.75
RUSTY W 2: folds 
*** FLOP *** [8d Ah 7h]
Haek82: bets $0.50
deepspace68: calls $0.50
*** TURN *** [8d Ah 7h] [4s]
Haek82: checks 
deepspace68: bets $1
Haek82: calls $1
*** RIVER *** [8d Ah 7h 4s] [Kd]
Haek82: checks 
deepspace68: checks 
*** SHOW DOWN ***
Haek82: shows [5d Ad] (a pair of Aces)
deepspace68: mucks hand 
Haek82 collected $5.25 from pot
*** SUMMARY ***
Total pot $5.50 | Rake $0.25 
Board [8d Ah 7h 4s Kd]
Seat 1: JMAC60 folded before Flop (didn't bet)
Seat 2: deepspace68 mucked [Js Jd]
Seat 3: YATAHA740 folded before Flop (didn't bet)
Seat 5: rockwhack folded before Flop (didn't bet)
Seat 6: finztothelft folded before Flop (didn't bet)
Seat 8: 1,1,2,3,5 (button) folded before Flop (didn't bet)
Seat 9: Haek82 (small blind) showed [5d Ad] and won ($5.25) with a pair of Aces
Seat 10: RUSTY W 2 (big blind) folded before Flop



PokerStars Game #6806872538:  Hold'em Limit ($0.50/$1.00) - 2006/10/28 - 19:52:27 (ET)
Table 'Tanina' 10-max Seat #9 is the button
Seat 1: JMAC60 ($12.65 in chips) 
Seat 2: deepspace68 ($35.65 in chips) 
Seat 3: YATAHA740 ($19.25 in chips) 
Seat 5: rockwhack ($24.60 in chips) 
Seat 6: finztothelft ($15.65 in chips) 
Seat 8: 1,1,2,3,5 ($21.80 in chips) 
Seat 9: Haek82 ($27.05 in chips) 
Seat 10: RUSTY W 2 ($32.60 in chips) 
RUSTY W 2: posts small blind $0.25
JMAC60: posts big blind $0.50
UncHerb38: sits out 
*** HOLE CARDS ***
Dealt to 1,1,2,3,5 [Qc 6d]
deepspace68: folds 
YATAHA740: folds 
rockwhack: folds 
finztothelft: folds 
1,1,2,3,5: folds 
Haek82: calls $0.50
Diego pb joins the table at seat #4 
RUSTY W 2: calls $0.25
JMAC60: checks 
*** FLOP *** [7s 8s Ts]
RUSTY W 2: bets $0.50
JMAC60: calls $0.50
Haek82: folds 
*** TURN *** [7s 8s Ts] [8d]
RUSTY W 2: bets $1
JMAC60: raises $1 to $2
RUSTY W 2: calls $1
*** RIVER *** [7s 8s Ts 8d] [Kd]
RUSTY W 2: checks 
JMAC60: bets $1
RUSTY W 2: calls $1
*** SHOW DOWN ***
JMAC60: shows [Qs Ks] (a flush, King high)
RUSTY W 2: mucks hand 
JMAC60 collected $8.10 from pot
*** SUMMARY ***
Total pot $8.50 | Rake $0.40 
Board [7s 8s Ts 8d Kd]
Seat 1: JMAC60 (big blind) showed [Qs Ks] and won ($8.10) with a flush, King high
Seat 2: deepspace68 folded before Flop (didn't bet)
Seat 3: YATAHA740 folded before Flop (didn't bet)
Seat 5: rockwhack folded before Flop (didn't bet)
Seat 6: finztothelft folded before Flop (didn't bet)
Seat 8: 1,1,2,3,5 folded before Flop (didn't bet)
Seat 9: Haek82 (button) folded on the Flop
Seat 10: RUSTY W 2 (small blind) mucked [9s 9h]



PokerStars Game #6806881272:  Hold'em Limit ($0.50/$1.00) - 2006/10/28 - 19:53:12 (ET)
Table 'Tanina' 10-max Seat #10 is the button
Seat 1: JMAC60 ($16.75 in chips) 
Seat 2: deepspace68 ($35.65 in chips) 
Seat 3: YATAHA740 ($19.25 in chips) 
Seat 5: rockwhack ($24.60 in chips) 
Seat 6: finztothelft ($15.65 in chips) 
Seat 8: 1,1,2,3,5 ($21.80 in chips) 
Seat 9: Haek82 ($26.55 in chips) 
Seat 10: RUSTY W 2 ($28.60 in chips) 
JMAC60: posts small blind $0.25
deepspace68: posts big blind $0.50
Diego pb: sits out 
UncHerb38: sits out 
*** HOLE CARDS ***
Dealt to 1,1,2,3,5 [2h Jd]
YATAHA740: folds 
rockwhack: folds 
finztothelft: folds 
1,1,2,3,5: folds 
Haek82: folds 
RUSTY W 2: folds 
JMAC60: folds 
deepspace68 collected $0.50 from pot
*** SUMMARY ***
Total pot $0.50 | Rake $0 
Seat 1: JMAC60 (small blind) folded before Flop
Seat 2: deepspace68 (big blind) collected ($0.50)
Seat 3: YATAHA740 folded before Flop (didn't bet)
Seat 5: rockwhack folded before Flop (didn't bet)
Seat 6: finztothelft folded before Flop (didn't bet)
Seat 8: 1,1,2,3,5 folded before Flop (didn't bet)
Seat 9: Haek82 folded before Flop (didn't bet)
Seat 10: RUSTY W 2 (button) folded before Flop (didn't bet)



PokerStars Game #6806884688:  Hold'em Limit ($0.50/$1.00) - 2006/10/28 - 19:53:30 (ET)
Table 'Tanina' 10-max Seat #1 is the button
Seat 1: JMAC60 ($16.50 in chips) 
Seat 2: deepspace68 ($35.90 in chips) 
Seat 3: YATAHA740 ($19.25 in chips) 
Seat 5: rockwhack ($24.60 in chips) 
Seat 6: finztothelft ($15.65 in chips) 
Seat 8: 1,1,2,3,5 ($21.80 in chips) 
Seat 9: Haek82 ($26.55 in chips) 
Seat 10: RUSTY W 2 ($28.60 in chips) 
deepspace68: posts small blind $0.25
YATAHA740: posts big blind $0.50
Diego pb: sits out 
UncHerb38: sits out 
*** HOLE CARDS ***
Dealt to 1,1,2,3,5 [2s Td]
rockwhack: folds 
finztothelft: folds 
1,1,2,3,5: folds 
Haek82: raises $0.50 to $1
RUSTY W 2: folds 
RUSTY W 2 leaves the table
JMAC60: folds 
deepspace68: folds 
YATAHA740: calls $0.50
*** FLOP *** [5c 3h Kh]
YATAHA740: checks 
Haek82: bets $0.50
YATAHA740: raises $0.50 to $1
Haek82: calls $0.50
*** TURN *** [5c 3h Kh] [3s]
YATAHA740: bets $1
Haek82: calls $1
*** RIVER *** [5c 3h Kh 3s] [Qc]
YATAHA740: bets $1
Haek82: calls $1
*** SHOW DOWN ***
YATAHA740: shows [As Ks] (two pair, Kings and Threes)
Haek82: mucks hand 
YATAHA740 collected $7.90 from pot
JmacnmeCrazy joins the table at seat #10 
*** SUMMARY ***
Total pot $8.25 | Rake $0.35 
Board [5c 3h Kh 3s Qc]
Seat 1: JMAC60 (button) folded before Flop (didn't bet)
Seat 2: deepspace68 (small blind) folded before Flop
Seat 3: YATAHA740 (big blind) showed [As Ks] and won ($7.90) with two pair, Kings and Threes
Seat 5: rockwhack folded before Flop (didn't bet)
Seat 6: finztothelft folded before Flop (didn't bet)
Seat 8: 1,1,2,3,5 folded before Flop (didn't bet)
Seat 9: Haek82 mucked [Qs Ac]
Seat 10: RUSTY W 2 folded before Flop (didn't bet)



PokerStars Game #6806893302:  Hold'em Limit ($0.50/$1.00) - 2006/10/28 - 19:54:15 (ET)
Table 'Tanina' 10-max Seat #2 is the button
Seat 1: JMAC60 ($16.50 in chips) 
Seat 2: deepspace68 ($35.65 in chips) 
Seat 3: YATAHA740 ($23.15 in chips) 
Seat 4: Diego pb ($20 in chips) 
Seat 5: rockwhack ($24.60 in chips) 
Seat 6: finztothelft ($15.65 in chips) 
Seat 7: UncHerb38 ($20 in chips) 
Seat 8: 1,1,2,3,5 ($21.80 in chips) 
Seat 9: Haek82 ($22.55 in chips) 
YATAHA740: posts small blind $0.25
Diego pb: posts big blind $0.50
UncHerb38: posts big blind $0.50
JmacnmeCrazy: sits out 
*** HOLE CARDS ***
Dealt to 1,1,2,3,5 [5s Tc]
rockwhack: folds 
finztothelft: folds 
UncHerb38: checks 
1,1,2,3,5: folds 
Haek82: raises $0.50 to $1
JMAC60: folds 
deepspace68: folds 
YATAHA740: folds 
Diego pb: folds 
UncHerb38: folds 
Haek82 collected $1.75 from pot
*** SUMMARY ***
Total pot $1.75 | Rake $0 
Seat 1: JMAC60 folded before Flop (didn't bet)
Seat 2: deepspace68 (button) folded before Flop (didn't bet)
Seat 3: YATAHA740 (small blind) folded before Flop
Seat 4: Diego pb (big blind) folded before Flop
Seat 5: rockwhack folded before Flop (didn't bet)
Seat 6: finztothelft folded before Flop (didn't bet)
Seat 7: UncHerb38 folded before Flop
Seat 8: 1,1,2,3,5 folded before Flop (didn't bet)
Seat 9: Haek82 collected ($1.75)



PokerStars Game #6806897259:  Hold'em Limit ($0.50/$1.00) - 2006/10/28 - 19:54:36 (ET)
Table 'Tanina' 10-max Seat #3 is the button
Seat 1: JMAC60 ($16.50 in chips) 
Seat 2: deepspace68 ($35.65 in chips) 
Seat 3: YATAHA740 ($22.90 in chips) 
Seat 4: Diego pb ($19.50 in chips) 
Seat 5: rockwhack ($24.60 in chips) 
Seat 6: finztothelft ($15.65 in chips) 
Seat 7: UncHerb38 ($19.50 in chips) 
Seat 8: 1,1,2,3,5 ($21.80 in chips) 
Seat 9: Haek82 ($23.80 in chips) 
Seat 10: JmacnmeCrazy ($20 in chips) 
Diego pb: posts small blind $0.25
rockwhack: posts big blind $0.50
JmacnmeCrazy: posts big blind $0.50
*** HOLE CARDS ***
Dealt to 1,1,2,3,5 [3d 2h]
finztothelft: folds 
UncHerb38: folds 
1,1,2,3,5: folds 
Haek82: raises $0.50 to $1
JmacnmeCrazy: calls $0.50
JMAC60: folds 
deepspace68: folds 
YATAHA740: folds 
Diego pb: folds 
rockwhack: calls $0.50
*** FLOP *** [Kd Qh 9d]
rockwhack: checks 
Haek82: checks 
JmacnmeCrazy: checks 
*** TURN *** [Kd Qh 9d] [Td]
rockwhack: bets $1
Haek82: raises $1 to $2
JmacnmeCrazy: folds 
rockwhack: raises $1 to $3
Haek82: calls $1
*** RIVER *** [Kd Qh 9d Td] [Qs]
rockwhack: bets $1
Haek82: calls $1
*** SHOW DOWN ***
rockwhack: shows [Ad Qd] (a flush, Ace high)
Haek82: mucks hand 
rockwhack collected $10.75 from pot
*** SUMMARY ***
Total pot $11.25 | Rake $0.50 
Board [Kd Qh 9d Td Qs]
Seat 1: JMAC60 folded before Flop (didn't bet)
Seat 2: deepspace68 folded before Flop (didn't bet)
Seat 3: YATAHA740 (button) folded before Flop (didn't bet)
Seat 4: Diego pb (small blind) folded before Flop
Seat 5: rockwhack (big blind) showed [Ad Qd] and won ($10.75) with a flush, Ace high
Seat 6: finztothelft folded before Flop (didn't bet)
Seat 7: UncHerb38 folded before Flop (didn't bet)
Seat 8: 1,1,2,3,5 folded before Flop (didn't bet)
Seat 9: Haek82 mucked [Jd As]
Seat 10: JmacnmeCrazy folded on the Turn



PokerStars Game #6806911006:  Hold'em Limit ($0.50/$1.00) - 2006/10/28 - 19:55:47 (ET)
Table 'Tanina' 10-max Seat #4 is the button
Seat 1: JMAC60 ($16.50 in chips) 
Seat 2: deepspace68 ($35.65 in chips) 
Seat 3: YATAHA740 ($22.90 in chips) 
Seat 4: Diego pb ($19.25 in chips) 
Seat 5: rockwhack ($30.35 in chips) 
Seat 6: finztothelft ($15.65 in chips) 
Seat 7: UncHerb38 ($19.50 in chips) 
Seat 8: 1,1,2,3,5 ($21.80 in chips) 
Seat 9: Haek82 ($18.80 in chips) 
Seat 10: JmacnmeCrazy ($19 in chips) 
rockwhack: posts small blind $0.25
finztothelft: posts big blind $0.50
*** HOLE CARDS ***
Dealt to 1,1,2,3,5 [Jh 3d]
UncHerb38: folds 
1,1,2,3,5: folds 
Haek82: folds 
JmacnmeCrazy: folds 
JMAC60: folds 
deepspace68: folds 
YATAHA740: folds 
Diego pb: folds 
rockwhack: raises $0.50 to $1
finztothelft: folds 
rockwhack collected $1 from pot
*** SUMMARY ***
Total pot $1 | Rake $0 
Seat 1: JMAC60 folded before Flop (didn't bet)
Seat 2: deepspace68 folded before Flop (didn't bet)
Seat 3: YATAHA740 folded before Flop (didn't bet)
Seat 4: Diego pb (button) folded before Flop (didn't bet)
Seat 5: rockwhack (small blind) collected ($1)
Seat 6: finztothelft (big blind) folded before Flop
Seat 7: UncHerb38 folded before Flop (didn't bet)
Seat 8: 1,1,2,3,5 folded before Flop (didn't bet)
Seat 9: Haek82 folded before Flop (didn't bet)
Seat 10: JmacnmeCrazy folded before Flop (didn't bet)



PokerStars Game #6806914961:  Hold'em Limit ($0.50/$1.00) - 2006/10/28 - 19:56:08 (ET)
Table 'Tanina' 10-max Seat #5 is the button
Seat 1: JMAC60 ($16.50 in chips) 
Seat 2: deepspace68 ($35.65 in chips) 
Seat 3: YATAHA740 ($22.90 in chips) 
Seat 4: Diego pb ($19.25 in chips) 
Seat 5: rockwhack ($30.85 in chips) 
Seat 6: finztothelft ($15.15 in chips) 
Seat 7: UncHerb38 ($19.50 in chips) 
Seat 8: 1,1,2,3,5 ($21.80 in chips) 
Seat 9: Haek82 ($18.80 in chips) 
Seat 10: JmacnmeCrazy ($19 in chips) 
finztothelft: posts small blind $0.25
UncHerb38: posts big blind $0.50
*** HOLE CARDS ***
Dealt to 1,1,2,3,5 [3h 5s]
1,1,2,3,5: folds 
Haek82: folds 
JmacnmeCrazy: calls $0.50
JMAC60: folds 
deepspace68: calls $0.50
YATAHA740: folds 
Diego pb: folds 
rockwhack: calls $0.50
finztothelft: raises $0.50 to $1
UncHerb38: folds 
JmacnmeCrazy: calls $0.50
deepspace68: calls $0.50
rockwhack: calls $0.50
*** FLOP *** [7c 9s 8c]
finztothelft: bets $0.50
JmacnmeCrazy: calls $0.50
deepspace68: raises $0.50 to $1
rockwhack: folds 
finztothelft: calls $0.50
JmacnmeCrazy: calls $0.50
*** TURN *** [7c 9s 8c] [Ac]
finztothelft: checks 
JmacnmeCrazy: checks 
deepspace68: bets $1
finztothelft: calls $1
JmacnmeCrazy: folds 
*** RIVER *** [7c 9s 8c Ac] [7d]
finztothelft: checks 
deepspace68: bets $1
finztothelft: calls $1
*** SHOW DOWN ***
deepspace68: shows [Js Th] (a straight, Seven to Jack)
finztothelft: mucks hand 
deepspace68 collected $11 from pot
*** SUMMARY ***
Total pot $11.50 | Rake $0.50 
Board [7c 9s 8c Ac 7d]
Seat 1: JMAC60 folded before Flop (didn't bet)
Seat 2: deepspace68 showed [Js Th] and won ($11) with a straight, Seven to Jack
Seat 3: YATAHA740 folded before Flop (didn't bet)
Seat 4: Diego pb folded before Flop (didn't bet)
Seat 5: rockwhack (button) folded on the Flop
Seat 6: finztothelft (small blind) mucked [As Kd]
Seat 7: UncHerb38 (big blind) folded before Flop
Seat 8: 1,1,2,3,5 folded before Flop (didn't bet)
Seat 9: Haek82 folded before Flop (didn't bet)
Seat 10: JmacnmeCrazy folded on the Turn



PokerStars Game #6806928979:  Hold'em Limit ($0.50/$1.00) - 2006/10/28 - 19:57:20 (ET)
Table 'Tanina' 10-max Seat #6 is the button
Seat 1: JMAC60 ($16.50 in chips) 
Seat 2: deepspace68 ($42.65 in chips) 
Seat 3: YATAHA740 ($22.90 in chips) 
Seat 4: Diego pb ($19.25 in chips) 
Seat 5: rockwhack ($29.85 in chips) 
Seat 6: finztothelft ($11.15 in chips) 
Seat 7: UncHerb38 ($19 in chips) 
Seat 8: 1,1,2,3,5 ($21.80 in chips) 
Seat 9: Haek82 ($18.80 in chips) 
Seat 10: JmacnmeCrazy ($17 in chips) 
UncHerb38: posts small blind $0.25
1,1,2,3,5: posts big blind $0.50
*** HOLE CARDS ***
Dealt to 1,1,2,3,5 [4s 5d]
Haek82: folds 
JmacnmeCrazy: calls $0.50
JMAC60: folds 
deepspace68: folds 
YATAHA740: folds 
Diego pb: folds 
rockwhack: folds 
finztothelft: folds 
UncHerb38: folds 
1,1,2,3,5: checks 
*** FLOP *** [6d 3d Ad]
1,1,2,3,5: bets $0.50
JmacnmeCrazy: calls $0.50
*** TURN *** [6d 3d Ad] [6s]
1,1,2,3,5: bets $1
JmacnmeCrazy: folds 
1,1,2,3,5 collected $2.15 from pot
1,1,2,3,5: doesn't show hand 
*** SUMMARY ***
Total pot $2.25 | Rake $0.10 
Board [6d 3d Ad 6s]
Seat 1: JMAC60 folded before Flop (didn't bet)
Seat 2: deepspace68 folded before Flop (didn't bet)
Seat 3: YATAHA740 folded before Flop (didn't bet)
Seat 4: Diego pb folded before Flop (didn't bet)
Seat 5: rockwhack folded before Flop (didn't bet)
Seat 6: finztothelft (button) folded before Flop (didn't bet)
Seat 7: UncHerb38 (small blind) folded before Flop
Seat 8: 1,1,2,3,5 (big blind) collected ($2.15)
Seat 9: Haek82 folded before Flop (didn't bet)
Seat 10: JmacnmeCrazy folded on the Turn



PokerStars Game #6806936110:  Hold'em Limit ($0.50/$1.00) - 2006/10/28 - 19:57:57 (ET)
Table 'Tanina' 10-max Seat #7 is the button
Seat 1: JMAC60 ($16.50 in chips) 
Seat 2: deepspace68 ($42.65 in chips) 
Seat 3: YATAHA740 ($22.90 in chips) 
Seat 4: Diego pb ($19.25 in chips) 
Seat 5: rockwhack ($29.85 in chips) 
Seat 6: finztothelft ($11.15 in chips) 
Seat 7: UncHerb38 ($18.75 in chips) 
Seat 8: 1,1,2,3,5 ($22.95 in chips) 
Seat 9: Haek82 ($18.80 in chips) 
Seat 10: JmacnmeCrazy ($16 in chips) 
1,1,2,3,5: posts small blind $0.25
Haek82: posts big blind $0.50
*** HOLE CARDS ***
Dealt to 1,1,2,3,5 [9d Qh]
JmacnmeCrazy: folds 
JMAC60: calls $0.50
deepspace68: folds 
YATAHA740: folds 
Diego pb: folds 
rockwhack: folds 
finztothelft: folds 
UncHerb38: folds 
1,1,2,3,5: folds 
Haek82: checks 
*** FLOP *** [Js Tc 2d]
Haek82: bets $0.50
JMAC60: raises $0.50 to $1
Haek82: calls $0.50
*** TURN *** [Js Tc 2d] [7c]
Haek82: checks 
JMAC60: bets $1
Haek82: calls $1
*** RIVER *** [Js Tc 2d 7c] [Ts]
Haek82: bets $1
JMAC60: folds 
Haek82 collected $5 from pot
*** SUMMARY ***
Total pot $5.25 | Rake $0.25 
Board [Js Tc 2d 7c Ts]
Seat 1: JMAC60 folded on the River
Seat 2: deepspace68 folded before Flop (didn't bet)
Seat 3: YATAHA740 folded before Flop (didn't bet)
Seat 4: Diego pb folded before Flop (didn't bet)
Seat 5: rockwhack folded before Flop (didn't bet)
Seat 6: finztothelft folded before Flop (didn't bet)
Seat 7: UncHerb38 (button) folded before Flop (didn't bet)
Seat 8: 1,1,2,3,5 (small blind) folded before Flop
Seat 9: Haek82 (big blind) collected ($5)
Seat 10: JmacnmeCrazy folded before Flop (didn't bet)



PokerStars Game #6806945022:  Hold'em Limit ($0.50/$1.00) - 2006/10/28 - 19:58:44 (ET)
Table 'Tanina' 10-max Seat #8 is the button
Seat 1: JMAC60 ($14 in chips) 
Seat 2: deepspace68 ($42.65 in chips) 
Seat 3: YATAHA740 ($22.90 in chips) 
Seat 4: Diego pb ($19.25 in chips) 
Seat 5: rockwhack ($29.85 in chips) 
Seat 6: finztothelft ($11.15 in chips) 
Seat 7: UncHerb38 ($18.75 in chips) 
Seat 8: 1,1,2,3,5 ($22.70 in chips) 
Seat 9: Haek82 ($21.30 in chips) 
Seat 10: JmacnmeCrazy ($16 in chips) 
Haek82: posts small blind $0.25
JmacnmeCrazy: posts big blind $0.50
*** HOLE CARDS ***
Dealt to 1,1,2,3,5 [Qd 6d]
JMAC60: folds 
deepspace68: folds 
YATAHA740: folds 
Diego pb: folds 
rockwhack: folds 
finztothelft: folds 
UncHerb38: folds 
1,1,2,3,5: folds 
Haek82: calls $0.25
JmacnmeCrazy: checks 
*** FLOP *** [4h 4c 5d]
Haek82: bets $0.50
JmacnmeCrazy: folds 
Haek82 collected $0.95 from pot
*** SUMMARY ***
Total pot $1 | Rake $0.05 
Board [4h 4c 5d]
Seat 1: JMAC60 folded before Flop (didn't bet)
Seat 2: deepspace68 folded before Flop (didn't bet)
Seat 3: YATAHA740 folded before Flop (didn't bet)
Seat 4: Diego pb folded before Flop (didn't bet)
Seat 5: rockwhack folded before Flop (didn't bet)
Seat 6: finztothelft folded before Flop (didn't bet)
Seat 7: UncHerb38 folded before Flop (didn't bet)
Seat 8: 1,1,2,3,5 (button) folded before Flop (didn't bet)
Seat 9: Haek82 (small blind) collected ($0.95)
Seat 10: JmacnmeCrazy (big blind) folded on the Flop



PokerStars Game #6806950887:  Hold'em Limit ($0.50/$1.00) - 2006/10/28 - 19:59:14 (ET)
Table 'Tanina' 10-max Seat #9 is the button
Seat 1: JMAC60 ($14 in chips) 
Seat 2: deepspace68 ($42.65 in chips) 
Seat 3: YATAHA740 ($22.90 in chips) 
Seat 4: Diego pb ($19.25 in chips) 
Seat 5: rockwhack ($29.85 in chips) 
Seat 6: finztothelft ($11.15 in chips) 
Seat 7: UncHerb38 ($18.75 in chips) 
Seat 8: 1,1,2,3,5 ($22.70 in chips) 
Seat 9: Haek82 ($21.75 in chips) 
Seat 10: JmacnmeCrazy ($15.50 in chips) 
JmacnmeCrazy: posts small blind $0.25
JMAC60: posts big blind $0.50
*** HOLE CARDS ***
Dealt to 1,1,2,3,5 [3d Th]
deepspace68: folds 
YATAHA740: folds 
Diego pb: folds 
rockwhack: folds 
finztothelft: folds 
UncHerb38: folds 
1,1,2,3,5: folds 
Haek82: folds 
JmacnmeCrazy: calls $0.25
JMAC60: checks 
*** FLOP *** [Kh Qd 6s]
JmacnmeCrazy: checks 
JMAC60: bets $0.50
JmacnmeCrazy: calls $0.50
*** TURN *** [Kh Qd 6s] [7c]
JmacnmeCrazy: checks 
JMAC60: bets $1
JmacnmeCrazy: raises $1 to $2
JMAC60: calls $1
*** RIVER *** [Kh Qd 6s 7c] [2c]
JmacnmeCrazy: bets $1
JMAC60: calls $1
*** SHOW DOWN ***
JmacnmeCrazy: shows [6h Qh] (two pair, Queens and Sixes)
JMAC60: mucks hand 
JmacnmeCrazy collected $7.65 from pot
*** SUMMARY ***
Total pot $8 | Rake $0.35 
Board [Kh Qd 6s 7c 2c]
Seat 1: JMAC60 (big blind) mucked [7s 9s]
Seat 2: deepspace68 folded before Flop (didn't bet)
Seat 3: YATAHA740 folded before Flop (didn't bet)
Seat 4: Diego pb folded before Flop (didn't bet)
Seat 5: rockwhack folded before Flop (didn't bet)
Seat 6: finztothelft folded before Flop (didn't bet)
Seat 7: UncHerb38 folded before Flop (didn't bet)
Seat 8: 1,1,2,3,5 folded before Flop (didn't bet)
Seat 9: Haek82 (button) folded before Flop (didn't bet)
Seat 10: JmacnmeCrazy (small blind) showed [6h Qh] and won ($7.65) with two pair, Queens and Sixes



PokerStars Game #6806960379:  Hold'em Limit ($0.50/$1.00) - 2006/10/28 - 20:00:03 (ET)
Table 'Tanina' 10-max Seat #10 is the button
Seat 1: JMAC60 ($10 in chips) 
Seat 2: deepspace68 ($42.65 in chips) 
Seat 3: YATAHA740 ($22.90 in chips) 
Seat 4: Diego pb ($19.25 in chips) 
Seat 5: rockwhack ($29.85 in chips) 
Seat 6: finztothelft ($11.15 in chips) 
Seat 7: UncHerb38 ($18.75 in chips) 
Seat 8: 1,1,2,3,5 ($22.70 in chips) 
Seat 9: Haek82 ($21.75 in chips) 
Seat 10: JmacnmeCrazy ($19.15 in chips) 
JMAC60: posts small blind $0.25
deepspace68: posts big blind $0.50
*** HOLE CARDS ***
Dealt to 1,1,2,3,5 [Qc 8s]
YATAHA740: calls $0.50
Diego pb: folds 
rockwhack: folds 
finztothelft: calls $0.50
UncHerb38: folds 
1,1,2,3,5: folds 
Haek82: raises $0.50 to $1
JmacnmeCrazy: folds 
JMAC60: calls $0.75
deepspace68: folds 
YATAHA740: calls $0.50
finztothelft: calls $0.50
*** FLOP *** [7h Kc 9d]
JMAC60: checks 
YATAHA740: checks 
finztothelft: checks 
Haek82: checks 
*** TURN *** [7h Kc 9d] [4s]
JMAC60: checks 
YATAHA740: checks 
finztothelft: checks 
Haek82: checks 
*** RIVER *** [7h Kc 9d 4s] [3d]
JMAC60: checks 
YATAHA740: checks 
finztothelft: checks 
Haek82: bets $1
JMAC60: calls $1
YATAHA740: folds 
finztothelft: folds 
*** SHOW DOWN ***
Haek82: shows [8d 8c] (a pair of Eights)
JMAC60: mucks hand 
Haek82 collected $6.20 from pot
*** SUMMARY ***
Total pot $6.50 | Rake $0.30 
Board [7h Kc 9d 4s 3d]
Seat 1: JMAC60 (small blind) mucked [Ac Jh]
Seat 2: deepspace68 (big blind) folded before Flop
Seat 3: YATAHA740 folded on the River
Seat 4: Diego pb folded before Flop (didn't bet)
Seat 5: rockwhack folded before Flop (didn't bet)
Seat 6: finztothelft folded on the River
Seat 7: UncHerb38 folded before Flop (didn't bet)
Seat 8: 1,1,2,3,5 folded before Flop (didn't bet)
Seat 9: Haek82 showed [8d 8c] and won ($6.20) with a pair of Eights
Seat 10: JmacnmeCrazy (button) folded before Flop (didn't bet)



PokerStars Game #6806973953:  Hold'em Limit ($0.50/$1.00) - 2006/10/28 - 20:01:15 (ET)
Table 'Tanina' 10-max Seat #1 is the button
Seat 1: JMAC60 ($8 in chips) 
Seat 2: deepspace68 ($42.15 in chips) 
Seat 3: YATAHA740 ($21.90 in chips) 
Seat 4: Diego pb ($19.25 in chips) 
Seat 5: rockwhack ($29.85 in chips) 
Seat 6: finztothelft ($10.15 in chips) 
Seat 7: UncHerb38 ($18.75 in chips) 
Seat 8: 1,1,2,3,5 ($22.70 in chips) 
Seat 9: Haek82 ($25.95 in chips) 
Seat 10: JmacnmeCrazy ($19.15 in chips) 
deepspace68: posts small blind $0.25
YATAHA740: posts big blind $0.50
*** HOLE CARDS ***
Dealt to 1,1,2,3,5 [2d Ts]
Diego pb: folds 
rockwhack: folds 
finztothelft: folds 
UncHerb38: folds 
1,1,2,3,5: folds 
Haek82: folds 
JmacnmeCrazy: calls $0.50
JMAC60: folds 
deepspace68: calls $0.25
YATAHA740: checks 
*** FLOP *** [8h Qd 5d]
deepspace68: checks 
YATAHA740: bets $0.50
JmacnmeCrazy: calls $0.50
deepspace68: folds 
*** TURN *** [8h Qd 5d] [5s]
YATAHA740: bets $1
JmacnmeCrazy: calls $1
*** RIVER *** [8h Qd 5d 5s] [7d]
YATAHA740: bets $1
JmacnmeCrazy: calls $1
*** SHOW DOWN ***
YATAHA740: shows [Qc Ah] (two pair, Queens and Fives)
JmacnmeCrazy: shows [Qh As] (two pair, Queens and Fives)
YATAHA740 collected $3.10 from pot
JmacnmeCrazy collected $3.10 from pot
*** SUMMARY ***
Total pot $6.50 | Rake $0.30 
Board [8h Qd 5d 5s 7d]
Seat 1: JMAC60 (button) folded before Flop (didn't bet)
Seat 2: deepspace68 (small blind) folded on the Flop
Seat 3: YATAHA740 (big blind) showed [Qc Ah] and won ($3.10) with two pair, Queens and Fives
Seat 4: Diego pb folded before Flop (didn't bet)
Seat 5: rockwhack folded before Flop (didn't bet)
Seat 6: finztothelft folded before Flop (didn't bet)
Seat 7: UncHerb38 folded before Flop (didn't bet)
Seat 8: 1,1,2,3,5 folded before Flop (didn't bet)
Seat 9: Haek82 folded before Flop (didn't bet)
Seat 10: JmacnmeCrazy showed [Qh As] and won ($3.10) with two pair, Queens and Fives



PokerStars Game #6806983117:  Hold'em Limit ($0.50/$1.00) - 2006/10/28 - 20:02:02 (ET)
Table 'Tanina' 10-max Seat #2 is the button
Seat 1: JMAC60 ($18 in chips) 
Seat 2: deepspace68 ($41.65 in chips) 
Seat 3: YATAHA740 ($22 in chips) 
Seat 4: Diego pb ($19.25 in chips) 
Seat 5: rockwhack ($29.85 in chips) 
Seat 6: finztothelft ($10.15 in chips) 
Seat 7: UncHerb38 ($18.75 in chips) 
Seat 8: 1,1,2,3,5 ($22.70 in chips) 
Seat 9: Haek82 ($25.95 in chips) 
Seat 10: JmacnmeCrazy ($19.25 in chips) 
YATAHA740: posts small blind $0.25
Diego pb: posts big blind $0.50
*** HOLE CARDS ***
Dealt to 1,1,2,3,5 [3d Ks]
rockwhack: folds 
finztothelft: folds 
UncHerb38: calls $0.50
1,1,2,3,5: folds 
Haek82: folds 
JmacnmeCrazy: calls $0.50
JMAC60: calls $0.50
deepspace68: folds 
YATAHA740: folds 
Diego pb: checks 
*** FLOP *** [2d Tc 7c]
Diego pb: checks 
UncHerb38: checks 
JmacnmeCrazy: checks 
JMAC60: bets $0.50
Diego pb: folds 
UncHerb38: folds 
JmacnmeCrazy: calls $0.50
*** TURN *** [2d Tc 7c] [Jh]
JmacnmeCrazy: checks 
JMAC60: checks 
*** RIVER *** [2d Tc 7c Jh] [2c]
JmacnmeCrazy: checks 
JMAC60: checks 
*** SHOW DOWN ***
JmacnmeCrazy: shows [7s 8c] (two pair, Sevens and Deuces)
JMAC60: mucks hand 
JmacnmeCrazy collected $3.10 from pot
*** SUMMARY ***
Total pot $3.25 | Rake $0.15 
Board [2d Tc 7c Jh 2c]
Seat 1: JMAC60 mucked [Ad 8d]
Seat 2: deepspace68 (button) folded before Flop (didn't bet)
Seat 3: YATAHA740 (small blind) folded before Flop
Seat 4: Diego pb (big blind) folded on the Flop
Seat 5: rockwhack folded before Flop (didn't bet)
Seat 6: finztothelft folded before Flop (didn't bet)
Seat 7: UncHerb38 folded on the Flop
Seat 8: 1,1,2,3,5 folded before Flop (didn't bet)
Seat 9: Haek82 folded before Flop (didn't bet)
Seat 10: JmacnmeCrazy showed [7s 8c] and won ($3.10) with two pair, Sevens and Deuces



PokerStars Game #6806996783:  Hold'em Limit ($0.50/$1.00) - 2006/10/28 - 20:03:07 (ET)
Table 'Tanina' 10-max Seat #3 is the button
Seat 1: JMAC60 ($17 in chips) 
Seat 2: deepspace68 ($41.65 in chips) 
Seat 3: YATAHA740 ($21.75 in chips) 
Seat 4: Diego pb ($18.75 in chips) 
Seat 5: rockwhack ($29.85 in chips) 
Seat 6: finztothelft ($10.15 in chips) 
Seat 7: UncHerb38 ($18.25 in chips) 
Seat 8: 1,1,2,3,5 ($22.70 in chips) 
Seat 9: Haek82 ($25.95 in chips) 
Seat 10: JmacnmeCrazy ($21.35 in chips) 
Diego pb: posts small blind $0.25
rockwhack: posts big blind $0.50
*** HOLE CARDS ***
Dealt to 1,1,2,3,5 [2s 7s]
finztothelft: folds 
UncHerb38: folds 
1,1,2,3,5: folds 
Haek82: raises $0.50 to $1
JmacnmeCrazy: folds 
JMAC60: folds 
deepspace68: folds 
YATAHA740: folds 
Diego pb: folds 
rockwhack: calls $0.50
*** FLOP *** [9c Jh Jc]
rockwhack: checks 
Haek82: checks 
*** TURN *** [9c Jh Jc] [6d]
rockwhack: bets $1
Haek82: calls $1
*** RIVER *** [9c Jh Jc 6d] [2h]
rockwhack: bets $1
Haek82: raises $1 to $2
rockwhack: calls $1
*** SHOW DOWN ***
Haek82: shows [Js Jd] (four of a kind, Jacks)
rockwhack: mucks hand 
Haek82 collected $7.85 from pot
*** SUMMARY ***
Total pot $8.25 | Rake $0.40 
Board [9c Jh Jc 6d 2h]
Seat 1: JMAC60 folded before Flop (didn't bet)
Seat 2: deepspace68 folded before Flop (didn't bet)
Seat 3: YATAHA740 (button) folded before Flop (didn't bet)
Seat 4: Diego pb (small blind) folded before Flop
Seat 5: rockwhack (big blind) mucked [7d 9d]
Seat 6: finztothelft folded before Flop (didn't bet)
Seat 7: UncHerb38 folded before Flop (didn't bet)
Seat 8: 1,1,2,3,5 folded before Flop (didn't bet)
Seat 9: Haek82 showed [Js Jd] and won ($7.85) with four of a kind, Jacks
Seat 10: JmacnmeCrazy folded before Flop (didn't bet)



PokerStars Game #6807007812:  Hold'em Limit ($0.50/$1.00) - 2006/10/28 - 20:03:59 (ET)
Table 'Tanina' 10-max Seat #4 is the button
Seat 1: JMAC60 ($17 in chips) 
Seat 2: deepspace68 ($41.65 in chips) 
Seat 3: YATAHA740 ($21.75 in chips) 
Seat 4: Diego pb ($18.50 in chips) 
Seat 5: rockwhack ($25.85 in chips) 
Seat 6: finztothelft ($10.15 in chips) 
Seat 7: UncHerb38 ($18.25 in chips) 
Seat 8: 1,1,2,3,5 ($22.70 in chips) 
Seat 9: Haek82 ($29.80 in chips) 
Seat 10: JmacnmeCrazy ($21.35 in chips) 
rockwhack: posts small blind $0.25
finztothelft: posts big blind $0.50
*** HOLE CARDS ***
Dealt to 1,1,2,3,5 [As Jh]
YATAHA740 said, "vnh"
UncHerb38: folds 
Haek82 said, "ty"
1,1,2,3,5: calls $0.50
Haek82 has timed out
Haek82: folds 
Haek82 is sitting out
JmacnmeCrazy: folds 
JMAC60: folds 
deepspace68: calls $0.50
YATAHA740: folds 
Haek82 has returned
Diego pb: raises $0.50 to $1
rockwhack: folds 
finztothelft: calls $0.50
1,1,2,3,5: calls $0.50
deepspace68: calls $0.50
*** FLOP *** [8s Ac 9d]
finztothelft: checks 
1,1,2,3,5: bets $0.50
deepspace68: folds 
Diego pb: raises $0.50 to $1
finztothelft: folds 
1,1,2,3,5: calls $0.50
*** TURN *** [8s Ac 9d] [Tc]
1,1,2,3,5: checks 
Diego pb: bets $1
1,1,2,3,5: calls $1
*** RIVER *** [8s Ac 9d Tc] [5d]
1,1,2,3,5: checks 
Diego pb: checks 
*** SHOW DOWN ***
1,1,2,3,5: shows [As Jh] (a pair of Aces)
Diego pb: shows [Qc Ah] (a pair of Aces - Queen kicker)
Diego pb collected $7.90 from pot
*** SUMMARY ***
Total pot $8.25 | Rake $0.35 
Board [8s Ac 9d Tc 5d]
Seat 1: JMAC60 folded before Flop (didn't bet)
Seat 2: deepspace68 folded on the Flop
Seat 3: YATAHA740 folded before Flop (didn't bet)
Seat 4: Diego pb (button) showed [Qc Ah] and won ($7.90) with a pair of Aces
Seat 5: rockwhack (small blind) folded before Flop
Seat 6: finztothelft (big blind) folded on the Flop
Seat 7: UncHerb38 folded before Flop (didn't bet)
Seat 8: 1,1,2,3,5 showed [As Jh] and lost with a pair of Aces
Seat 9: Haek82 folded before Flop (didn't bet)
Seat 10: JmacnmeCrazy folded before Flop (didn't bet)



PokerStars Game #6807023331:  Hold'em Limit ($0.50/$1.00) - 2006/10/28 - 20:05:15 (ET)
Table 'Tanina' 10-max Seat #5 is the button
Seat 1: JMAC60 ($17 in chips) 
Seat 2: deepspace68 ($40.65 in chips) 
Seat 3: YATAHA740 ($21.75 in chips) 
Seat 4: Diego pb ($23.40 in chips) 
Seat 5: rockwhack ($25.60 in chips) 
Seat 6: finztothelft ($9.15 in chips) 
Seat 7: UncHerb38 ($18.25 in chips) 
Seat 8: 1,1,2,3,5 ($19.70 in chips) 
Seat 9: Haek82 ($29.80 in chips) 
Seat 10: JmacnmeCrazy ($21.35 in chips) 
finztothelft: posts small blind $0.25
UncHerb38: posts big blind $0.50
*** HOLE CARDS ***
Dealt to 1,1,2,3,5 [Qc 2c]
1,1,2,3,5: folds 
Haek82: folds 
JmacnmeCrazy: folds 
JMAC60: folds 
deepspace68: folds 
YATAHA740: folds 
Diego pb: folds 
rockwhack: raises $0.50 to $1
finztothelft: calls $0.75
UncHerb38: folds 
*** FLOP *** [6h 7s Ks]
finztothelft: checks 
rockwhack: bets $0.50
finztothelft: folds 
rockwhack collected $2.40 from pot
*** SUMMARY ***
Total pot $2.50 | Rake $0.10 
Board [6h 7s Ks]
Seat 1: JMAC60 folded before Flop (didn't bet)
Seat 2: deepspace68 folded before Flop (didn't bet)
Seat 3: YATAHA740 folded before Flop (didn't bet)
Seat 4: Diego pb folded before Flop (didn't bet)
Seat 5: rockwhack (button) collected ($2.40)
Seat 6: finztothelft (small blind) folded on the Flop
Seat 7: UncHerb38 (big blind) folded before Flop
Seat 8: 1,1,2,3,5 folded before Flop (didn't bet)
Seat 9: Haek82 folded before Flop (didn't bet)
Seat 10: JmacnmeCrazy folded before Flop (didn't bet)



PokerStars Game #6807029012:  Hold'em Limit ($0.50/$1.00) - 2006/10/28 - 20:05:42 (ET)
Table 'Tanina' 10-max Seat #6 is the button
Seat 1: JMAC60 ($17 in chips) 
Seat 2: deepspace68 ($40.65 in chips) 
Seat 3: YATAHA740 ($21.75 in chips) 
Seat 4: Diego pb ($23.40 in chips) 
Seat 5: rockwhack ($27 in chips) 
Seat 6: finztothelft ($8.15 in chips) 
Seat 7: UncHerb38 ($17.75 in chips) 
Seat 8: 1,1,2,3,5 ($19.70 in chips) 
Seat 9: Haek82 ($29.80 in chips) 
Seat 10: JmacnmeCrazy ($21.35 in chips) 
UncHerb38: posts small blind $0.25
1,1,2,3,5: posts big blind $0.50
*** HOLE CARDS ***
Dealt to 1,1,2,3,5 [6d 5s]
Haek82: folds 
JmacnmeCrazy: folds 
JMAC60: folds 
deepspace68: calls $0.50
YATAHA740: folds 
Diego pb: folds 
rockwhack: calls $0.50
finztothelft: folds 
UncHerb38: folds 
1,1,2,3,5: checks 
*** FLOP *** [Ks Jd 3h]
1,1,2,3,5: checks 
deepspace68: checks 
rockwhack: bets $0.50
1,1,2,3,5: folds 
deepspace68: folds 
rockwhack collected $1.70 from pot
*** SUMMARY ***
Total pot $1.75 | Rake $0.05 
Board [Ks Jd 3h]
Seat 1: JMAC60 folded before Flop (didn't bet)
Seat 2: deepspace68 folded on the Flop
Seat 3: YATAHA740 folded before Flop (didn't bet)
Seat 4: Diego pb folded before Flop (didn't bet)
Seat 5: rockwhack collected ($1.70)
Seat 6: finztothelft (button) folded before Flop (didn't bet)
Seat 7: UncHerb38 (small blind) folded before Flop
Seat 8: 1,1,2,3,5 (big blind) folded on the Flop
Seat 9: Haek82 folded before Flop (didn't bet)
Seat 10: JmacnmeCrazy folded before Flop (didn't bet)



PokerStars Game #6807038478:  Hold'em Limit ($0.50/$1.00) - 2006/10/28 - 20:06:28 (ET)
Table 'Tanina' 10-max Seat #7 is the button
Seat 1: JMAC60 ($17 in chips) 
Seat 2: deepspace68 ($40.15 in chips) 
Seat 3: YATAHA740 ($21.75 in chips) 
Seat 4: Diego pb ($23.40 in chips) 
Seat 5: rockwhack ($28.20 in chips) 
Seat 6: finztothelft ($8.15 in chips) 
Seat 7: UncHerb38 ($17.50 in chips) 
Seat 8: 1,1,2,3,5 ($19.20 in chips) 
Seat 9: Haek82 ($29.80 in chips) 
Seat 10: JmacnmeCrazy ($21.35 in chips) 
1,1,2,3,5: posts small blind $0.25
Haek82: posts big blind $0.50
*** HOLE CARDS ***
Dealt to 1,1,2,3,5 [Ks 7d]
JmacnmeCrazy: folds 
JMAC60: raises $0.50 to $1
deepspace68: folds 
YATAHA740: folds 
Diego pb: folds 
rockwhack: folds 
finztothelft: folds 
UncHerb38: calls $1
1,1,2,3,5: folds 
Haek82: calls $0.50
*** FLOP *** [7s Js Jc]
Haek82: bets $0.50
JMAC60: calls $0.50
UncHerb38: calls $0.50
*** TURN *** [7s Js Jc] [Kc]
Haek82: bets $1
JMAC60: calls $1
UncHerb38: calls $1
*** RIVER *** [7s Js Jc Kc] [Ad]
Haek82: checks 
JMAC60: bets $1
UncHerb38: calls $1
Haek82: calls $1
*** SHOW DOWN ***
JMAC60: shows [Qs Ac] (two pair, Aces and Jacks)
UncHerb38: mucks hand 
Haek82: mucks hand 
JMAC60 collected $10.25 from pot
*** SUMMARY ***
Total pot $10.75 | Rake $0.50 
Board [7s Js Jc Kc Ad]
Seat 1: JMAC60 showed [Qs Ac] and won ($10.25) with two pair, Aces and Jacks
Seat 2: deepspace68 folded before Flop (didn't bet)
Seat 3: YATAHA740 folded before Flop (didn't bet)
Seat 4: Diego pb folded before Flop (didn't bet)
Seat 5: rockwhack folded before Flop (didn't bet)
Seat 6: finztothelft folded before Flop (didn't bet)
Seat 7: UncHerb38 (button) mucked [9c 9h]
Seat 8: 1,1,2,3,5 (small blind) folded before Flop
Seat 9: Haek82 (big blind) mucked [Kh 7h]
Seat 10: JmacnmeCrazy folded before Flop (didn't bet)



PokerStars Game #6807049936:  Hold'em Limit ($0.50/$1.00) - 2006/10/28 - 20:07:24 (ET)
Table 'Tanina' 10-max Seat #8 is the button
Seat 1: JMAC60 ($23.75 in chips) 
Seat 2: deepspace68 ($40.15 in chips) 
Seat 3: YATAHA740 ($21.75 in chips) 
Seat 4: Diego pb ($23.40 in chips) 
Seat 5: rockwhack ($28.20 in chips) 
Seat 6: finztothelft ($8.15 in chips) 
Seat 7: UncHerb38 ($14 in chips) 
Seat 8: 1,1,2,3,5 ($18.95 in chips) 
Seat 9: Haek82 ($26.30 in chips) 
Seat 10: JmacnmeCrazy ($21.35 in chips) 
Haek82: posts small blind $0.25
JmacnmeCrazy: posts big blind $0.50
*** HOLE CARDS ***
Dealt to 1,1,2,3,5 [9h 3s]
JMAC60: folds 
deepspace68: calls $0.50
YATAHA740: folds 
Diego pb: folds 
rockwhack: calls $0.50
finztothelft: calls $0.50
UncHerb38: folds 
UncHerb38 leaves the table
1,1,2,3,5: folds 
Haek82: folds 
JmacnmeCrazy: checks 
*** FLOP *** [9s 3c 2s]
JmacnmeCrazy: checks 
deepspace68: checks 
rockwhack: bets $0.50
finztothelft: calls $0.50
JmacnmeCrazy: folds 
deepspace68: calls $0.50
*** TURN *** [9s 3c 2s] [5d]
deepspace68: checks 
rockwhack: bets $1
finztothelft: folds 
deepspace68: calls $1
*** RIVER *** [9s 3c 2s 5d] [4s]
deepspace68: checks 
rockwhack: checks 
*** SHOW DOWN ***
deepspace68: shows [2c Ac] (a straight, Ace to Five)
rockwhack: shows [Ah 8h] (a straight, Ace to Five)
deepspace68 collected $2.75 from pot
rockwhack collected $2.75 from pot
*** SUMMARY ***
Total pot $5.75 | Rake $0.25 
Board [9s 3c 2s 5d 4s]
Seat 1: JMAC60 folded before Flop (didn't bet)
Seat 2: deepspace68 showed [2c Ac] and won ($2.75) with a straight, Ace to Five
Seat 3: YATAHA740 folded before Flop (didn't bet)
Seat 4: Diego pb folded before Flop (didn't bet)
Seat 5: rockwhack showed [Ah 8h] and won ($2.75) with a straight, Ace to Five
Seat 6: finztothelft folded on the Turn
Seat 7: UncHerb38 folded before Flop (didn't bet)
Seat 8: 1,1,2,3,5 (button) folded before Flop (didn't bet)
Seat 9: Haek82 (small blind) folded before Flop
Seat 10: JmacnmeCrazy (big blind) folded on the Flop



PokerStars Game #6807061875:  Hold'em Limit ($0.50/$1.00) - 2006/10/28 - 20:08:23 (ET)
Table 'Tanina' 10-max Seat #9 is the button
Seat 1: JMAC60 ($23.75 in chips) 
Seat 2: deepspace68 ($40.90 in chips) 
Seat 3: YATAHA740 ($21.75 in chips) 
Seat 4: Diego pb ($23.40 in chips) 
Seat 5: rockwhack ($28.95 in chips) 
Seat 6: finztothelft ($7.15 in chips) 
Seat 8: 1,1,2,3,5 ($18.95 in chips) 
Seat 9: Haek82 ($26.05 in chips) 
Seat 10: JmacnmeCrazy ($20.85 in chips) 
JmacnmeCrazy: posts small blind $0.25
JMAC60: posts big blind $0.50
*** HOLE CARDS ***
Dealt to 1,1,2,3,5 [3c Jd]
deepspace68: folds 
YATAHA740: calls $0.50
Marcoj916 joins the table at seat #7 
Diego pb: folds 
rockwhack: calls $0.50
finztothelft: raises $0.50 to $1
1,1,2,3,5: folds 
Haek82: calls $1
JmacnmeCrazy: folds 
JMAC60: folds 
YATAHA740: calls $0.50
rockwhack: calls $0.50
*** FLOP *** [Qd Qh 6s]
YATAHA740: checks 
rockwhack: checks 
finztothelft: bets $0.50
Haek82: calls $0.50
YATAHA740: calls $0.50
rockwhack: folds 
*** TURN *** [Qd Qh 6s] [Jc]
YATAHA740: checks 
finztothelft: bets $1
Haek82: folds 
YATAHA740: folds 
finztothelft collected $5.95 from pot
*** SUMMARY ***
Total pot $6.25 | Rake $0.30 
Board [Qd Qh 6s Jc]
Seat 1: JMAC60 (big blind) folded before Flop
Seat 2: deepspace68 folded before Flop (didn't bet)
Seat 3: YATAHA740 folded on the Turn
Seat 4: Diego pb folded before Flop (didn't bet)
Seat 5: rockwhack folded on the Flop
Seat 6: finztothelft collected ($5.95)
Seat 8: 1,1,2,3,5 folded before Flop (didn't bet)
Seat 9: Haek82 (button) folded on the Turn
Seat 10: JmacnmeCrazy (small blind) folded before Flop



PokerStars Game #6807072061:  Hold'em Limit ($0.50/$1.00) - 2006/10/28 - 20:09:13 (ET)
Table 'Tanina' 10-max Seat #10 is the button
Seat 1: JMAC60 ($23.25 in chips) 
Seat 2: deepspace68 ($40.90 in chips) 
Seat 3: YATAHA740 ($20.25 in chips) 
Seat 4: Diego pb ($23.40 in chips) 
Seat 5: rockwhack ($27.95 in chips) 
Seat 6: finztothelft ($11.60 in chips) 
Seat 7: Marcoj916 ($40 in chips) 
Seat 8: 1,1,2,3,5 ($18.95 in chips) 
Seat 9: Haek82 ($24.55 in chips) 
Seat 10: JmacnmeCrazy ($20.60 in chips) 
JMAC60: posts small blind $0.25
deepspace68: posts big blind $0.50
Marcoj916: posts big blind $0.50
*** HOLE CARDS ***
Dealt to 1,1,2,3,5 [8s 8h]
YATAHA740: folds 
Diego pb: calls $0.50
rockwhack: calls $0.50
finztothelft: folds 
Marcoj916: checks 
1,1,2,3,5: calls $0.50
Haek82: folds 
JmacnmeCrazy: calls $0.50
JMAC60: calls $0.25
deepspace68: checks 
*** FLOP *** [Qs Ac 3s]
JMAC60: checks 
deepspace68: checks 
Diego pb: bets $0.50
rockwhack: calls $0.50
Marcoj916: raises $0.50 to $1
1,1,2,3,5: folds 
JmacnmeCrazy: calls $1
JMAC60: folds 
deepspace68: folds 
Diego pb: calls $0.50
rockwhack: calls $0.50
*** TURN *** [Qs Ac 3s] [6d]
Diego pb: checks 
rockwhack: checks 
Marcoj916: bets $1
JmacnmeCrazy: calls $1
Diego pb: calls $1
rockwhack: folds 
*** RIVER *** [Qs Ac 3s 6d] [2c]
Diego pb: checks 
Marcoj916: bets $1
JmacnmeCrazy: calls $1
Diego pb: folds 
*** SHOW DOWN ***
Marcoj916: shows [3h Qh] (two pair, Queens and Threes)
JmacnmeCrazy: mucks hand 
Marcoj916 collected $12 from pot
*** SUMMARY ***
Total pot $12.50 | Rake $0.50 
Board [Qs Ac 3s 6d 2c]
Seat 1: JMAC60 (small blind) folded on the Flop
Seat 2: deepspace68 (big blind) folded on the Flop
Seat 3: YATAHA740 folded before Flop (didn't bet)
Seat 4: Diego pb folded on the River
Seat 5: rockwhack folded on the Turn
Seat 6: finztothelft folded before Flop (didn't bet)
Seat 7: Marcoj916 showed [3h Qh] and won ($12) with two pair, Queens and Threes
Seat 8: 1,1,2,3,5 folded on the Flop
Seat 9: Haek82 folded before Flop (didn't bet)
Seat 10: JmacnmeCrazy (button) mucked [Ah Ks]



PokerStars Game #6807086868:  Hold'em Limit ($0.50/$1.00) - 2006/10/28 - 20:10:26 (ET)
Table 'Tanina' 10-max Seat #1 is the button
Seat 1: JMAC60 ($22.75 in chips) 
Seat 2: deepspace68 ($40.40 in chips) 
Seat 3: YATAHA740 ($20.25 in chips) 
Seat 4: Diego pb ($20.90 in chips) 
Seat 5: rockwhack ($26.45 in chips) 
Seat 6: finztothelft ($11.60 in chips) 
Seat 7: Marcoj916 ($48.50 in chips) 
Seat 8: 1,1,2,3,5 ($18.45 in chips) 
Seat 9: Haek82 ($24.55 in chips) 
Seat 10: JmacnmeCrazy ($17.10 in chips) 
deepspace68: posts small blind $0.25
YATAHA740: posts big blind $0.50
*** HOLE CARDS ***
Dealt to 1,1,2,3,5 [8h Kh]
Diego pb: calls $0.50
rockwhack: folds 
finztothelft: folds 
Marcoj916: folds 
1,1,2,3,5: folds 
Haek82: calls $0.50
JmacnmeCrazy: calls $0.50
JMAC60: calls $0.50
deepspace68: calls $0.25
YATAHA740: checks 
*** FLOP *** [Jd 4s Tc]
deepspace68: checks 
YATAHA740: checks 
Diego pb: bets $0.50
Haek82: folds 
JmacnmeCrazy: calls $0.50
JMAC60: folds 
deepspace68: calls $0.50
YATAHA740: folds 
*** TURN *** [Jd 4s Tc] [7c]
deepspace68: checks 
Diego pb: bets $1
JmacnmeCrazy: raises $1 to $2
deepspace68: folds 
Diego pb: calls $1
*** RIVER *** [Jd 4s Tc 7c] [Ad]
Diego pb: bets $1
JmacnmeCrazy: calls $1
*** SHOW DOWN ***
Diego pb: shows [Ks As] (a pair of Aces)
JmacnmeCrazy: mucks hand 
Diego pb collected $10 from pot
*** SUMMARY ***
Total pot $10.50 | Rake $0.50 
Board [Jd 4s Tc 7c Ad]
Seat 1: JMAC60 (button) folded on the Flop
Seat 2: deepspace68 (small blind) folded on the Turn
Seat 3: YATAHA740 (big blind) folded on the Flop
Seat 4: Diego pb showed [Ks As] and won ($10) with a pair of Aces
Seat 5: rockwhack folded before Flop (didn't bet)
Seat 6: finztothelft folded before Flop (didn't bet)
Seat 7: Marcoj916 folded before Flop (didn't bet)
Seat 8: 1,1,2,3,5 folded before Flop (didn't bet)
Seat 9: Haek82 folded on the Flop
Seat 10: JmacnmeCrazy mucked [Qs Jh]



PokerStars Game #6807098544:  Hold'em Limit ($0.50/$1.00) - 2006/10/28 - 20:11:24 (ET)
Table 'Tanina' 10-max Seat #2 is the button
Seat 1: JMAC60 ($22.25 in chips) 
Seat 2: deepspace68 ($39.40 in chips) 
Seat 3: YATAHA740 ($19.75 in chips) 
Seat 4: Diego pb ($26.90 in chips) 
Seat 5: rockwhack ($26.45 in chips) 
Seat 6: finztothelft ($11.60 in chips) 
Seat 7: Marcoj916 ($48.50 in chips) 
Seat 8: 1,1,2,3,5 ($18.45 in chips) 
Seat 9: Haek82 ($24.05 in chips) 
Seat 10: JmacnmeCrazy ($13.10 in chips) 
YATAHA740: posts small blind $0.25
Diego pb: posts big blind $0.50
*** HOLE CARDS ***
Dealt to 1,1,2,3,5 [6d 8c]
rockwhack: folds 
finztothelft: folds 
Marcoj916: folds 
1,1,2,3,5: folds 
Haek82: calls $0.50
JmacnmeCrazy: folds 
JMAC60: folds 
deepspace68: calls $0.50
YATAHA740: calls $0.25
Diego pb: checks 
*** FLOP *** [Qd 5s Tc]
YATAHA740: checks 
Diego pb: folds 
Haek82: checks 
deepspace68: checks 
*** TURN *** [Qd 5s Tc] [8h]
YATAHA740: checks 
Haek82: checks 
deepspace68: checks 
*** RIVER *** [Qd 5s Tc 8h] [2c]
YATAHA740: bets $1
Haek82: folds 
deepspace68: folds 
YATAHA740 collected $1.90 from pot
YATAHA740: doesn't show hand 
*** SUMMARY ***
Total pot $2 | Rake $0.10 
Board [Qd 5s Tc 8h 2c]
Seat 1: JMAC60 folded before Flop (didn't bet)
Seat 2: deepspace68 (button) folded on the River
Seat 3: YATAHA740 (small blind) collected ($1.90)
Seat 4: Diego pb (big blind) folded on the Flop
Seat 5: rockwhack folded before Flop (didn't bet)
Seat 6: finztothelft folded before Flop (didn't bet)
Seat 7: Marcoj916 folded before Flop (didn't bet)
Seat 8: 1,1,2,3,5 folded before Flop (didn't bet)
Seat 9: Haek82 folded on the River
Seat 10: JmacnmeCrazy folded before Flop (didn't bet)



PokerStars Game #6807109144:  Hold'em Limit ($0.50/$1.00) - 2006/10/28 - 20:12:16 (ET)
Table 'Tanina' 10-max Seat #3 is the button
Seat 1: JMAC60 ($22.25 in chips) 
Seat 2: deepspace68 ($38.90 in chips) 
Seat 3: YATAHA740 ($21.15 in chips) 
Seat 4: Diego pb ($26.40 in chips) 
Seat 5: rockwhack ($26.45 in chips) 
Seat 6: finztothelft ($11.60 in chips) 
Seat 7: Marcoj916 ($48.50 in chips) 
Seat 8: 1,1,2,3,5 ($18.45 in chips) 
Seat 9: Haek82 ($23.55 in chips) 
Seat 10: JmacnmeCrazy ($13.10 in chips) 
Diego pb: posts small blind $0.25
rockwhack: posts big blind $0.50
*** HOLE CARDS ***
Dealt to 1,1,2,3,5 [2d 5d]
finztothelft: folds 
Marcoj916: folds 
1,1,2,3,5: folds 
Haek82: folds 
JmacnmeCrazy: folds 
JMAC60: folds 
deepspace68: folds 
YATAHA740: calls $0.50
Diego pb: folds 
rockwhack: checks 
*** FLOP *** [3s 2h 8h]
rockwhack: bets $0.50
YATAHA740: calls $0.50
*** TURN *** [3s 2h 8h] [8d]
rockwhack: bets $1
YATAHA740: folds 
rockwhack collected $2.15 from pot
*** SUMMARY ***
Total pot $2.25 | Rake $0.10 
Board [3s 2h 8h 8d]
Seat 1: JMAC60 folded before Flop (didn't bet)
Seat 2: deepspace68 folded before Flop (didn't bet)
Seat 3: YATAHA740 (button) folded on the Turn
Seat 4: Diego pb (small blind) folded before Flop
Seat 5: rockwhack (big blind) collected ($2.15)
Seat 6: finztothelft folded before Flop (didn't bet)
Seat 7: Marcoj916 folded before Flop (didn't bet)
Seat 8: 1,1,2,3,5 folded before Flop (didn't bet)
Seat 9: Haek82 folded before Flop (didn't bet)
Seat 10: JmacnmeCrazy folded before Flop (didn't bet)



PokerStars Game #6807115689:  Hold'em Limit ($0.50/$1.00) - 2006/10/28 - 20:12:49 (ET)
Table 'Tanina' 10-max Seat #4 is the button
Seat 1: JMAC60 ($22.25 in chips) 
Seat 2: deepspace68 ($38.90 in chips) 
Seat 3: YATAHA740 ($20.15 in chips) 
Seat 4: Diego pb ($26.15 in chips) 
Seat 5: rockwhack ($27.60 in chips) 
Seat 6: finztothelft ($11.60 in chips) 
Seat 7: Marcoj916 ($48.50 in chips) 
Seat 8: 1,1,2,3,5 ($18.45 in chips) 
Seat 9: Haek82 ($23.55 in chips) 
Seat 10: JmacnmeCrazy ($13.10 in chips) 
rockwhack: posts small blind $0.25
finztothelft: posts big blind $0.50
*** HOLE CARDS ***
Dealt to 1,1,2,3,5 [Th 3h]
Marcoj916: folds 
1,1,2,3,5: folds 
Haek82: folds 
JmacnmeCrazy: calls $0.50
JMAC60: folds 
deepspace68: calls $0.50
YATAHA740: folds 
Diego pb: calls $0.50
rockwhack: folds 
finztothelft: checks 
*** FLOP *** [Ac Jh Kc]
finztothelft: checks 
JmacnmeCrazy: checks 
deepspace68: bets $0.50
Diego pb: folds 
finztothelft: folds 
JmacnmeCrazy: calls $0.50
*** TURN *** [Ac Jh Kc] [2h]
JmacnmeCrazy: checks 
deepspace68: bets $1
JmacnmeCrazy: calls $1
*** RIVER *** [Ac Jh Kc 2h] [Ks]
JmacnmeCrazy: checks 
deepspace68: bets $1
JmacnmeCrazy: calls $1
*** SHOW DOWN ***
deepspace68: shows [Qh As] (two pair, Aces and Kings)
JmacnmeCrazy: mucks hand 
deepspace68 collected $6.90 from pot
*** SUMMARY ***
Total pot $7.25 | Rake $0.35 
Board [Ac Jh Kc 2h Ks]
Seat 1: JMAC60 folded before Flop (didn't bet)
Seat 2: deepspace68 showed [Qh As] and won ($6.90) with two pair, Aces and Kings
Seat 3: YATAHA740 folded before Flop (didn't bet)
Seat 4: Diego pb (button) folded on the Flop
Seat 5: rockwhack (small blind) folded before Flop
Seat 6: finztothelft (big blind) folded on the Flop
Seat 7: Marcoj916 folded before Flop (didn't bet)
Seat 8: 1,1,2,3,5 folded before Flop (didn't bet)
Seat 9: Haek82 folded before Flop (didn't bet)
Seat 10: JmacnmeCrazy mucked [Ad 6h]



PokerStars Game #6807126581:  Hold'em Limit ($0.50/$1.00) - 2006/10/28 - 20:13:43 (ET)
Table 'Tanina' 10-max Seat #5 is the button
Seat 1: JMAC60 ($22.25 in chips) 
Seat 2: deepspace68 ($42.80 in chips) 
Seat 3: YATAHA740 ($20.15 in chips) 
Seat 4: Diego pb ($25.65 in chips) 
Seat 5: rockwhack ($27.35 in chips) 
Seat 6: finztothelft ($11.10 in chips) 
Seat 7: Marcoj916 ($48.50 in chips) 
Seat 8: 1,1,2,3,5 ($18.45 in chips) 
Seat 9: Haek82 ($23.55 in chips) 
Seat 10: JmacnmeCrazy ($10.10 in chips) 
finztothelft: posts small blind $0.25
Marcoj916: posts big blind $0.50
*** HOLE CARDS ***
Dealt to 1,1,2,3,5 [Kc Th]
1,1,2,3,5: folds 
Haek82: folds 
JmacnmeCrazy: calls $0.50
JMAC60: calls $0.50
deepspace68: folds 
YATAHA740: calls $0.50
Diego pb: folds 
rockwhack: calls $0.50
finztothelft: folds 
Marcoj916: checks 
*** FLOP *** [Js Jh 2h]
Marcoj916: checks 
JmacnmeCrazy: checks 
JMAC60: bets $0.50
YATAHA740: calls $0.50
rockwhack: raises $0.50 to $1
Marcoj916: folds 
JmacnmeCrazy: folds 
JMAC60: calls $0.50
YATAHA740: calls $0.50
*** TURN *** [Js Jh 2h] [Ac]
JMAC60: checks 
YATAHA740: checks 
rockwhack: checks 
*** RIVER *** [Js Jh 2h Ac] [5c]
JMAC60: bets $1
YATAHA740: raises $1 to $2
rockwhack: folds 
JMAC60: calls $1
*** SHOW DOWN ***
YATAHA740: shows [Ah 5h] (two pair, Aces and Jacks)
JMAC60: shows [Jc 9c] (three of a kind, Jacks)
JMAC60 collected $9.30 from pot
*** SUMMARY ***
Total pot $9.75 | Rake $0.45 
Board [Js Jh 2h Ac 5c]
Seat 1: JMAC60 showed [Jc 9c] and won ($9.30) with three of a kind, Jacks
Seat 2: deepspace68 folded before Flop (didn't bet)
Seat 3: YATAHA740 showed [Ah 5h] and lost with two pair, Aces and Jacks
Seat 4: Diego pb folded before Flop (didn't bet)
Seat 5: rockwhack (button) folded on the River
Seat 6: finztothelft (small blind) folded before Flop
Seat 7: Marcoj916 (big blind) folded on the Flop
Seat 8: 1,1,2,3,5 folded before Flop (didn't bet)
Seat 9: Haek82 folded before Flop (didn't bet)
Seat 10: JmacnmeCrazy folded on the Flop



PokerStars Game #6807140533:  Hold'em Limit ($0.50/$1.00) - 2006/10/28 - 20:14:53 (ET)
Table 'Tanina' 10-max Seat #6 is the button
Seat 1: JMAC60 ($28.05 in chips) 
Seat 2: deepspace68 ($42.80 in chips) 
Seat 3: YATAHA740 ($16.65 in chips) 
Seat 4: Diego pb ($25.65 in chips) 
Seat 5: rockwhack ($25.85 in chips) 
Seat 6: finztothelft ($10.85 in chips) 
Seat 7: Marcoj916 ($48 in chips) 
Seat 8: 1,1,2,3,5 ($18.45 in chips) 
Seat 9: Haek82 ($23.55 in chips) 
Seat 10: JmacnmeCrazy ($9.60 in chips) 
Marcoj916: posts small blind $0.25
1,1,2,3,5: posts big blind $0.50
*** HOLE CARDS ***
Dealt to 1,1,2,3,5 [4d Js]
Haek82: folds 
JmacnmeCrazy: calls $0.50
JMAC60: folds 
deepspace68: calls $0.50
YATAHA740: raises $0.50 to $1
Diego pb: folds 
YATAHA740 said, "nh"
rockwhack: folds 
finztothelft: calls $1
Marcoj916: folds 
1,1,2,3,5: folds 
JmacnmeCrazy: calls $0.50
deepspace68: calls $0.50
*** FLOP *** [3d 9d 3h]
JmacnmeCrazy: checks 
deepspace68: checks 
YATAHA740: bets $0.50
finztothelft: folds 
JmacnmeCrazy: calls $0.50
deepspace68: folds 
*** TURN *** [3d 9d 3h] [Jc]
JmacnmeCrazy: checks 
YATAHA740: bets $1
JmacnmeCrazy: folds 
YATAHA740 collected $5.50 from pot
YATAHA740: doesn't show hand 
*** SUMMARY ***
Total pot $5.75 | Rake $0.25 
Board [3d 9d 3h Jc]
Seat 1: JMAC60 folded before Flop (didn't bet)
Seat 2: deepspace68 folded on the Flop
Seat 3: YATAHA740 collected ($5.50)
Seat 4: Diego pb folded before Flop (didn't bet)
Seat 5: rockwhack folded before Flop (didn't bet)
Seat 6: finztothelft (button) folded on the Flop
Seat 7: Marcoj916 (small blind) folded before Flop
Seat 8: 1,1,2,3,5 (big blind) folded before Flop
Seat 9: Haek82 folded before Flop (didn't bet)
Seat 10: JmacnmeCrazy folded on the Turn



PokerStars Game #6807151356:  Hold'em Limit ($0.50/$1.00) - 2006/10/28 - 20:15:45 (ET)
Table 'Tanina' 10-max Seat #7 is the button
Seat 1: JMAC60 ($28.05 in chips) 
Seat 2: deepspace68 ($41.80 in chips) 
Seat 3: YATAHA740 ($20.65 in chips) 
Seat 4: Diego pb ($25.65 in chips) 
Seat 5: rockwhack ($25.85 in chips) 
Seat 6: finztothelft ($9.85 in chips) 
Seat 7: Marcoj916 ($47.75 in chips) 
Seat 8: 1,1,2,3,5 ($17.95 in chips) 
Seat 9: Haek82 ($23.55 in chips) 
Seat 10: JmacnmeCrazy ($8.10 in chips) 
1,1,2,3,5: posts small blind $0.25
Haek82: posts big blind $0.50
*** HOLE CARDS ***
Dealt to 1,1,2,3,5 [4d Qc]
JmacnmeCrazy: folds 
JMAC60: folds 
deepspace68: calls $0.50
YATAHA740: folds 
Diego pb: folds 
rockwhack: folds 
finztothelft: folds 
Marcoj916: folds 
1,1,2,3,5: folds 
JmacnmeCrazy leaves the table
Haek82: checks 
*** FLOP *** [5c 7h Qs]
Haek82: checks 
deepspace68: bets $0.50
Haek82: calls $0.50
*** TURN *** [5c 7h Qs] [Kh]
Haek82: checks 
deepspace68: bets $1
Haek82: raises $1 to $2
deepspace68: folds 
Haek82 collected $4.05 from pot
*** SUMMARY ***
Total pot $4.25 | Rake $0.20 
Board [5c 7h Qs Kh]
Seat 1: JMAC60 folded before Flop (didn't bet)
Seat 2: deepspace68 folded on the Turn
Seat 3: YATAHA740 folded before Flop (didn't bet)
Seat 4: Diego pb folded before Flop (didn't bet)
Seat 5: rockwhack folded before Flop (didn't bet)
Seat 6: finztothelft folded before Flop (didn't bet)
Seat 7: Marcoj916 (button) folded before Flop (didn't bet)
Seat 8: 1,1,2,3,5 (small blind) folded before Flop
Seat 9: Haek82 (big blind) collected ($4.05)
Seat 10: JmacnmeCrazy folded before Flop (didn't bet)



PokerStars Game #6807158712:  Hold'em Limit ($0.50/$1.00) - 2006/10/28 - 20:16:21 (ET)
Table 'Tanina' 10-max Seat #8 is the button
Seat 1: JMAC60 ($28.05 in chips) 
Seat 2: deepspace68 ($39.80 in chips) 
Seat 3: YATAHA740 ($20.65 in chips) 
Seat 4: Diego pb ($25.65 in chips) 
Seat 5: rockwhack ($25.85 in chips) 
Seat 6: finztothelft ($9.85 in chips) 
Seat 7: Marcoj916 ($47.75 in chips) 
Seat 8: 1,1,2,3,5 ($17.70 in chips) 
Seat 9: Haek82 ($25.60 in chips) 
Haek82: posts small blind $0.25
JMAC60: posts big blind $0.50
*** HOLE CARDS ***
Dealt to 1,1,2,3,5 [Jd Qs]
deepspace68: folds 
YATAHA740: calls $0.50
Diego pb: folds 
rockwhack: folds 
finztothelft: folds 
Marcoj916: calls $0.50
1,1,2,3,5: folds 
Haek82: folds 
JMAC60: checks 
*** FLOP *** [Th 3s Kd]
JMAC60: bets $0.50
YATAHA740: folds 
Marcoj916: folds 
JMAC60 collected $1.70 from pot
JMAC60: doesn't show hand 
*** SUMMARY ***
Total pot $1.75 | Rake $0.05 
Board [Th 3s Kd]
Seat 1: JMAC60 (big blind) collected ($1.70)
Seat 2: deepspace68 folded before Flop (didn't bet)
Seat 3: YATAHA740 folded on the Flop
Seat 4: Diego pb folded before Flop (didn't bet)
Seat 5: rockwhack folded before Flop (didn't bet)
Seat 6: finztothelft folded before Flop (didn't bet)
Seat 7: Marcoj916 folded on the Flop
Seat 8: 1,1,2,3,5 (button) folded before Flop (didn't bet)
Seat 9: Haek82 (small blind) folded before Flop



PokerStars Game #6807166272:  Hold'em Limit ($0.50/$1.00) - 2006/10/28 - 20:16:58 (ET)
Table 'Tanina' 10-max Seat #9 is the button
Seat 1: JMAC60 ($29.25 in chips) 
Seat 2: deepspace68 ($39.80 in chips) 
Seat 3: YATAHA740 ($20.15 in chips) 
Seat 4: Diego pb ($25.65 in chips) 
Seat 5: rockwhack ($25.85 in chips) 
Seat 6: finztothelft ($9.85 in chips) 
Seat 7: Marcoj916 ($47.25 in chips) 
Seat 8: 1,1,2,3,5 ($17.70 in chips) 
Seat 9: Haek82 ($25.35 in chips) 
JMAC60: posts small blind $0.25
deepspace68: posts big blind $0.50
*** HOLE CARDS ***
Dealt to 1,1,2,3,5 [Kc 6h]
YATAHA740: folds 
Diego pb: folds 
rockwhack: calls $0.50
1nyyfan joins the table at seat #10 
finztothelft: folds 
YATAHA740 leaves the table
Marcoj916: folds 
1,1,2,3,5: folds 
Haek82: folds 
JMAC60: folds 
deepspace68: checks 
*** FLOP *** [Ad 4s 9d]
deepspace68: checks 
Rockush420 joins the table at seat #3 
rockwhack: bets $0.50
deepspace68: calls $0.50
*** TURN *** [Ad 4s 9d] [3h]
deepspace68: checks 
rockwhack: bets $1
deepspace68: calls $1
*** RIVER *** [Ad 4s 9d 3h] [Kh]
deepspace68: checks 
rockwhack: checks 
*** SHOW DOWN ***
deepspace68: shows [Qd 6d] (high card Ace)
rockwhack: mucks hand 
deepspace68 collected $4.05 from pot
*** SUMMARY ***
Total pot $4.25 | Rake $0.20 
Board [Ad 4s 9d 3h Kh]
Seat 1: JMAC60 (small blind) folded before Flop
Seat 2: deepspace68 (big blind) showed [Qd 6d] and won ($4.05) with high card Ace
Seat 3: YATAHA740 folded before Flop (didn't bet)
Seat 4: Diego pb folded before Flop (didn't bet)
Seat 5: rockwhack mucked [Th Jc]
Seat 6: finztothelft folded before Flop (didn't bet)
Seat 7: Marcoj916 folded before Flop (didn't bet)
Seat 8: 1,1,2,3,5 folded before Flop (didn't bet)
Seat 9: Haek82 (button) folded before Flop (didn't bet)



PokerStars Game #6807174821:  Hold'em Limit ($0.50/$1.00) - 2006/10/28 - 20:17:40 (ET)
Table 'Tanina' 10-max Seat #1 is the button
Seat 1: JMAC60 ($29 in chips) 
Seat 2: deepspace68 ($41.85 in chips) 
Seat 3: Rockush420 ($20 in chips) 
Seat 4: Diego pb ($25.65 in chips) 
Seat 5: rockwhack ($23.85 in chips) 
Seat 6: finztothelft ($9.85 in chips) 
Seat 7: Marcoj916 ($47.25 in chips) 
Seat 8: 1,1,2,3,5 ($17.70 in chips) 
Seat 9: Haek82 ($25.35 in chips) 
Seat 10: 1nyyfan ($20 in chips) 
deepspace68: posts small blind $0.25
Rockush420: posts big blind $0.50
1nyyfan: posts big blind $0.50
*** HOLE CARDS ***
Dealt to 1,1,2,3,5 [6s 9c]
Diego pb: calls $0.50
rockwhack: calls $0.50
finztothelft: raises $0.50 to $1
Marcoj916: folds 
1,1,2,3,5: folds 
Haek82: folds 
1nyyfan: folds 
JMAC60: folds 
deepspace68: folds 
Rockush420: calls $0.50
Diego pb: calls $0.50
rockwhack: calls $0.50
*** FLOP *** [6h As 8d]
Rockush420: checks 
Diego pb: checks 
rockwhack: checks 
finztothelft: bets $0.50
Rockush420: folds 
Diego pb: calls $0.50
rockwhack: calls $0.50
*** TURN *** [6h As 8d] [Tc]
Diego pb: checks 
rockwhack: checks 
finztothelft: bets $1
Diego pb: calls $1
rockwhack: calls $1
*** RIVER *** [6h As 8d Tc] [Kc]
Diego pb: checks 
rockwhack: checks 
finztothelft: bets $1
Diego pb: folds 
rockwhack: calls $1
*** SHOW DOWN ***
finztothelft: shows [Kh Kd] (three of a kind, Kings)
rockwhack: mucks hand 
finztothelft collected $10.75 from pot
*** SUMMARY ***
Total pot $11.25 | Rake $0.50 
Board [6h As 8d Tc Kc]
Seat 1: JMAC60 (button) folded before Flop (didn't bet)
Seat 2: deepspace68 (small blind) folded before Flop
Seat 3: Rockush420 (big blind) folded on the Flop
Seat 4: Diego pb folded on the River
Seat 5: rockwhack mucked [Jh Th]
Seat 6: finztothelft showed [Kh Kd] and won ($10.75) with three of a kind, Kings
Seat 7: Marcoj916 folded before Flop (didn't bet)
Seat 8: 1,1,2,3,5 folded before Flop (didn't bet)
Seat 9: Haek82 folded before Flop (didn't bet)
Seat 10: 1nyyfan folded before Flop



PokerStars Game #6807185805:  Hold'em Limit ($0.50/$1.00) - 2006/10/28 - 20:18:35 (ET)
Table 'Tanina' 10-max Seat #2 is the button
Seat 1: JMAC60 ($29 in chips) 
Seat 2: deepspace68 ($41.60 in chips) 
Seat 3: Rockush420 ($19 in chips) 
Seat 4: Diego pb ($23.15 in chips) 
Seat 5: rockwhack ($20.35 in chips) 
Seat 6: finztothelft ($17.10 in chips) 
Seat 7: Marcoj916 ($47.25 in chips) 
Seat 8: 1,1,2,3,5 ($17.70 in chips) 
Seat 9: Haek82 ($25.35 in chips) 
Seat 10: 1nyyfan ($19.50 in chips) 
Rockush420: posts small blind $0.25
Diego pb: posts big blind $0.50
*** HOLE CARDS ***
Dealt to 1,1,2,3,5 [Td 3h]
rockwhack: folds 
finztothelft: folds 
Marcoj916: folds 
1,1,2,3,5: folds 
Haek82: raises $0.50 to $1
1nyyfan: folds 
JMAC60: folds 
deepspace68: folds 
Rockush420: folds 
Diego pb: calls $0.50
*** FLOP *** [5h 6c 8s]
Diego pb: bets $0.50
Haek82: raises $0.50 to $1
Diego pb: raises $0.50 to $1.50
Haek82: calls $0.50
*** TURN *** [5h 6c 8s] [9d]
Diego pb: bets $1
Haek82: calls $1
*** RIVER *** [5h 6c 8s 9d] [4s]
Diego pb: bets $1
Haek82: calls $1
*** SHOW DOWN ***
Diego pb: shows [Kh 8c] (a pair of Eights)
Haek82: shows [Qs Qd] (a pair of Queens)
Haek82 collected $8.85 from pot
*** SUMMARY ***
Total pot $9.25 | Rake $0.40 
Board [5h 6c 8s 9d 4s]
Seat 1: JMAC60 folded before Flop (didn't bet)
Seat 2: deepspace68 (button) folded before Flop (didn't bet)
Seat 3: Rockush420 (small blind) folded before Flop
Seat 4: Diego pb (big blind) showed [Kh 8c] and lost with a pair of Eights
Seat 5: rockwhack folded before Flop (didn't bet)
Seat 6: finztothelft folded before Flop (didn't bet)
Seat 7: Marcoj916 folded before Flop (didn't bet)
Seat 8: 1,1,2,3,5 folded before Flop (didn't bet)
Seat 9: Haek82 showed [Qs Qd] and won ($8.85) with a pair of Queens
Seat 10: 1nyyfan folded before Flop (didn't bet)



PokerStars Game #6807193414:  Hold'em Limit ($0.50/$1.00) - 2006/10/28 - 20:19:12 (ET)
Table 'Tanina' 10-max Seat #3 is the button
Seat 1: JMAC60 ($29 in chips) 
Seat 2: deepspace68 ($41.60 in chips) 
Seat 3: Rockush420 ($18.75 in chips) 
Seat 4: Diego pb ($18.65 in chips) 
Seat 5: rockwhack ($20.35 in chips) 
Seat 6: finztothelft ($17.10 in chips) 
Seat 7: Marcoj916 ($47.25 in chips) 
Seat 8: 1,1,2,3,5 ($17.70 in chips) 
Seat 9: Haek82 ($29.70 in chips) 
Seat 10: 1nyyfan ($19.50 in chips) 
Diego pb: posts small blind $0.25
rockwhack: posts big blind $0.50
*** HOLE CARDS ***
Dealt to 1,1,2,3,5 [8h 2s]
finztothelft: folds 
Marcoj916: folds 
1,1,2,3,5: folds 
Haek82: folds 
1nyyfan: folds 
JMAC60: folds 
deepspace68: calls $0.50
Rockush420: folds 
Diego pb: calls $0.25
rockwhack: checks 
*** FLOP *** [5c Ks Jh]
Diego pb: checks 
rockwhack: checks 
deepspace68: checks 
*** TURN *** [5c Ks Jh] [6s]
Diego pb: checks 
rockwhack: checks 
deepspace68: bets $1
Diego pb: folds 
rockwhack: folds 
deepspace68 collected $1.45 from pot
*** SUMMARY ***
Total pot $1.50 | Rake $0.05 
Board [5c Ks Jh 6s]
Seat 1: JMAC60 folded before Flop (didn't bet)
Seat 2: deepspace68 collected ($1.45)
Seat 3: Rockush420 (button) folded before Flop (didn't bet)
Seat 4: Diego pb (small blind) folded on the Turn
Seat 5: rockwhack (big blind) folded on the Turn
Seat 6: finztothelft folded before Flop (didn't bet)
Seat 7: Marcoj916 folded before Flop (didn't bet)
Seat 8: 1,1,2,3,5 folded before Flop (didn't bet)
Seat 9: Haek82 folded before Flop (didn't bet)
Seat 10: 1nyyfan folded before Flop (didn't bet)



PokerStars Game #6807203911:  Hold'em Limit ($0.50/$1.00) - 2006/10/28 - 20:20:04 (ET)
Table 'Tanina' 10-max Seat #4 is the button
Seat 1: JMAC60 ($29 in chips) 
Seat 2: deepspace68 ($42.55 in chips) 
Seat 3: Rockush420 ($18.75 in chips) 
Seat 4: Diego pb ($18.15 in chips) 
Seat 5: rockwhack ($19.85 in chips) 
Seat 6: finztothelft ($17.10 in chips) 
Seat 7: Marcoj916 ($47.25 in chips) 
Seat 8: 1,1,2,3,5 ($17.70 in chips) 
Seat 9: Haek82 ($29.70 in chips) 
Seat 10: 1nyyfan ($19.50 in chips) 
rockwhack: posts small blind $0.25
finztothelft: posts big blind $0.50
*** HOLE CARDS ***
Dealt to 1,1,2,3,5 [3s Qs]
Marcoj916: folds 
1,1,2,3,5: folds 
Haek82: folds 
1nyyfan: folds 
JMAC60: folds 
deepspace68: calls $0.50
Rockush420: calls $0.50
Diego pb: folds 
rockwhack: calls $0.25
finztothelft: checks 
*** FLOP *** [9d 6h 9s]
rockwhack: bets $0.50
finztothelft: folds 
deepspace68: folds 
Rockush420: calls $0.50
*** TURN *** [9d 6h 9s] [6c]
rockwhack: checks 
Rockush420: checks 
*** RIVER *** [9d 6h 9s 6c] [Kc]
rockwhack: bets $1
Rockush420: folds 
rockwhack collected $2.90 from pot
rockwhack: doesn't show hand 
*** SUMMARY ***
Total pot $3 | Rake $0.10 
Board [9d 6h 9s 6c Kc]
Seat 1: JMAC60 folded before Flop (didn't bet)
Seat 2: deepspace68 folded on the Flop
Seat 3: Rockush420 folded on the River
Seat 4: Diego pb (button) folded before Flop (didn't bet)
Seat 5: rockwhack (small blind) collected ($2.90)
Seat 6: finztothelft (big blind) folded on the Flop
Seat 7: Marcoj916 folded before Flop (didn't bet)
Seat 8: 1,1,2,3,5 folded before Flop (didn't bet)
Seat 9: Haek82 folded before Flop (didn't bet)
Seat 10: 1nyyfan folded before Flop (didn't bet)



PokerStars Game #6807212619:  Hold'em Limit ($0.50/$1.00) - 2006/10/28 - 20:20:47 (ET)
Table 'Tanina' 10-max Seat #5 is the button
Seat 1: JMAC60 ($29 in chips) 
Seat 2: deepspace68 ($42.05 in chips) 
Seat 3: Rockush420 ($17.75 in chips) 
Seat 4: Diego pb ($18.15 in chips) 
Seat 5: rockwhack ($21.75 in chips) 
Seat 6: finztothelft ($16.60 in chips) 
Seat 7: Marcoj916 ($47.25 in chips) 
Seat 8: 1,1,2,3,5 ($17.70 in chips) 
Seat 9: Haek82 ($29.70 in chips) 
Seat 10: 1nyyfan ($19.50 in chips) 
finztothelft: posts small blind $0.25
Marcoj916: posts big blind $0.50
*** HOLE CARDS ***
Dealt to 1,1,2,3,5 [3s 2c]
1,1,2,3,5: folds 
Haek82: folds 
1nyyfan: folds 
JMAC60: folds 
deepspace68: folds 
Rockush420: folds 
Diego pb: folds 
rockwhack: folds 
finztothelft: raises $0.50 to $1
Marcoj916: folds 
finztothelft collected $1 from pot
*** SUMMARY ***
Total pot $1 | Rake $0 
Seat 1: JMAC60 folded before Flop (didn't bet)
Seat 2: deepspace68 folded before Flop (didn't bet)
Seat 3: Rockush420 folded before Flop (didn't bet)
Seat 4: Diego pb folded before Flop (didn't bet)
Seat 5: rockwhack (button) folded before Flop (didn't bet)
Seat 6: finztothelft (small blind) collected ($1)
Seat 7: Marcoj916 (big blind) folded before Flop
Seat 8: 1,1,2,3,5 folded before Flop (didn't bet)
Seat 9: Haek82 folded before Flop (didn't bet)
Seat 10: 1nyyfan folded before Flop (didn't bet)



PokerStars Game #6807217905:  Hold'em Limit ($0.50/$1.00) - 2006/10/28 - 20:21:14 (ET)
Table 'Tanina' 10-max Seat #6 is the button
Seat 1: JMAC60 ($29 in chips) 
Seat 2: deepspace68 ($42.05 in chips) 
Seat 3: Rockush420 ($17.75 in chips) 
Seat 4: Diego pb ($18.15 in chips) 
Seat 5: rockwhack ($21.75 in chips) 
Seat 6: finztothelft ($17.10 in chips) 
Seat 7: Marcoj916 ($46.75 in chips) 
Seat 8: 1,1,2,3,5 ($17.70 in chips) 
Seat 9: Haek82 ($29.70 in chips) 
Seat 10: 1nyyfan ($19.50 in chips) 
Marcoj916: posts small blind $0.25
1,1,2,3,5: posts big blind $0.50
*** HOLE CARDS ***
Dealt to 1,1,2,3,5 [Qh 4h]
Haek82: folds 
1nyyfan: folds 
JMAC60: calls $0.50
deepspace68: folds 
Rockush420: folds 
Diego pb: folds 
rockwhack: calls $0.50
finztothelft: folds 
Marcoj916: calls $0.25
1,1,2,3,5: checks 
*** FLOP *** [5d 7h 3c]
Marcoj916: checks 
1,1,2,3,5: checks 
JMAC60: bets $0.50
rockwhack: raises $0.50 to $1
Marcoj916: folds 
1,1,2,3,5: folds 
JMAC60: calls $0.50
*** TURN *** [5d 7h 3c] [4c]
JMAC60: checks 
rockwhack: bets $1
JMAC60: folds 
rockwhack collected $3.85 from pot
rockwhack: doesn't show hand 
*** SUMMARY ***
Total pot $4 | Rake $0.15 
Board [5d 7h 3c 4c]
Seat 1: JMAC60 folded on the Turn
Seat 2: deepspace68 folded before Flop (didn't bet)
Seat 3: Rockush420 folded before Flop (didn't bet)
Seat 4: Diego pb folded before Flop (didn't bet)
Seat 5: rockwhack collected ($3.85)
Seat 6: finztothelft (button) folded before Flop (didn't bet)
Seat 7: Marcoj916 (small blind) folded on the Flop
Seat 8: 1,1,2,3,5 (big blind) folded on the Flop
Seat 9: Haek82 folded before Flop (didn't bet)
Seat 10: 1nyyfan folded before Flop (didn't bet)



PokerStars Game #6807228476:  Hold'em Limit ($0.50/$1.00) - 2006/10/28 - 20:22:06 (ET)
Table 'Tanina' 10-max Seat #7 is the button
Seat 1: JMAC60 ($27.50 in chips) 
Seat 2: deepspace68 ($42.05 in chips) 
Seat 3: Rockush420 ($17.75 in chips) 
Seat 4: Diego pb ($18.15 in chips) 
Seat 5: rockwhack ($24.10 in chips) 
Seat 6: finztothelft ($17.10 in chips) 
Seat 7: Marcoj916 ($46.25 in chips) 
Seat 8: 1,1,2,3,5 ($17.20 in chips) 
Seat 9: Haek82 ($29.70 in chips) 
Seat 10: 1nyyfan ($19.50 in chips) 
1,1,2,3,5: posts small blind $0.25
Haek82: posts big blind $0.50
*** HOLE CARDS ***
Dealt to 1,1,2,3,5 [3c As]
1nyyfan: folds 
JMAC60: folds 
deepspace68: folds 
Rockush420: folds 
Diego pb: folds 
rockwhack: folds 
finztothelft: folds 
Marcoj916: folds 
1,1,2,3,5: folds 
Haek82 collected $0.50 from pot
*** SUMMARY ***
Total pot $0.50 | Rake $0 
Seat 1: JMAC60 folded before Flop (didn't bet)
Seat 2: deepspace68 folded before Flop (didn't bet)
Seat 3: Rockush420 folded before Flop (didn't bet)
Seat 4: Diego pb folded before Flop (didn't bet)
Seat 5: rockwhack folded before Flop (didn't bet)
Seat 6: finztothelft folded before Flop (didn't bet)
Seat 7: Marcoj916 (button) folded before Flop (didn't bet)
Seat 8: 1,1,2,3,5 (small blind) folded before Flop
Seat 9: Haek82 (big blind) collected ($0.50)
Seat 10: 1nyyfan folded before Flop (didn't bet)



PokerStars Game #6807231783:  Hold'em Limit ($0.50/$1.00) - 2006/10/28 - 20:22:22 (ET)
Table 'Tanina' 10-max Seat #8 is the button
Seat 1: JMAC60 ($27.50 in chips) 
Seat 2: deepspace68 ($42.05 in chips) 
Seat 3: Rockush420 ($17.75 in chips) 
Seat 4: Diego pb ($18.15 in chips) 
Seat 5: rockwhack ($24.10 in chips) 
Seat 6: finztothelft ($17.10 in chips) 
Seat 7: Marcoj916 ($46.25 in chips) 
Seat 8: 1,1,2,3,5 ($16.95 in chips) 
Seat 9: Haek82 ($29.95 in chips) 
Seat 10: 1nyyfan ($19.50 in chips) 
Haek82: posts small blind $0.25
1nyyfan: posts big blind $0.50
*** HOLE CARDS ***
Dealt to 1,1,2,3,5 [2s 7c]
JMAC60: folds 
deepspace68: folds 
Rockush420: calls $0.50
Diego pb: folds 
rockwhack: calls $0.50
finztothelft: calls $0.50
Marcoj916: folds 
1,1,2,3,5: folds 
Haek82: folds 
1nyyfan: checks 
*** FLOP *** [8s As 9h]
1nyyfan: checks 
Rockush420: checks 
rockwhack: bets $0.50
finztothelft: calls $0.50
1nyyfan: calls $0.50
Rockush420: raises $0.50 to $1
rockwhack: raises $0.50 to $1.50
finztothelft: calls $1
1nyyfan: calls $1
Rockush420: calls $0.50
*** TURN *** [8s As 9h] [5d]
1nyyfan: checks 
Rockush420: checks 
rockwhack: bets $1
finztothelft: calls $1
1nyyfan: calls $1
Rockush420: calls $1
*** RIVER *** [8s As 9h 5d] [9d]
1nyyfan: checks 
Rockush420: checks 
rockwhack: checks 
finztothelft: checks 
*** SHOW DOWN ***
1nyyfan: shows [Jh Th] (a pair of Nines)
Rockush420: shows [6s Ks] (a pair of Nines - Ace+King kicker)
rockwhack: shows [3d Ad] (two pair, Aces and Nines)
finztothelft: shows [Ah 5h] (two pair, Aces and Nines)
rockwhack collected $5.90 from pot
finztothelft collected $5.85 from pot
*** SUMMARY ***
Total pot $12.25 | Rake $0.50 
Board [8s As 9h 5d 9d]
Seat 1: JMAC60 folded before Flop (didn't bet)
Seat 2: deepspace68 folded before Flop (didn't bet)
Seat 3: Rockush420 showed [6s Ks] and lost with a pair of Nines
Seat 4: Diego pb folded before Flop (didn't bet)
Seat 5: rockwhack showed [3d Ad] and won ($5.90) with two pair, Aces and Nines
Seat 6: finztothelft showed [Ah 5h] and won ($5.85) with two pair, Aces and Nines
Seat 7: Marcoj916 folded before Flop (didn't bet)
Seat 8: 1,1,2,3,5 (button) folded before Flop (didn't bet)
Seat 9: Haek82 (small blind) folded before Flop
Seat 10: 1nyyfan (big blind) showed [Jh Th] and lost with a pair of Nines



PokerStars Game #6807250142:  Hold'em Limit ($0.50/$1.00) - 2006/10/28 - 20:23:53 (ET)
Table 'Tanina' 10-max Seat #9 is the button
Seat 1: JMAC60 ($27.50 in chips) 
Seat 2: deepspace68 ($42.05 in chips) 
Seat 3: Rockush420 ($14.75 in chips) 
Seat 4: Diego pb ($18.15 in chips) 
Seat 5: rockwhack ($27 in chips) 
Seat 6: finztothelft ($19.95 in chips) 
Seat 7: Marcoj916 ($46.25 in chips) 
Seat 8: 1,1,2,3,5 ($16.95 in chips) 
Seat 9: Haek82 ($29.70 in chips) 
Seat 10: 1nyyfan ($16.50 in chips) 
1nyyfan: posts small blind $0.25
JMAC60: posts big blind $0.50
*** HOLE CARDS ***
Dealt to 1,1,2,3,5 [As Td]
deepspace68: folds 
Rockush420: folds 
Diego pb: folds 
rockwhack: raises $0.50 to $1
finztothelft: folds 
Marcoj916: folds 
1,1,2,3,5: folds 
Haek82: folds 
1nyyfan: folds 
JMAC60: calls $0.50
*** FLOP *** [4c 4d 8h]
JMAC60: checks 
rockwhack: bets $0.50
JMAC60: folds 
rockwhack collected $2.15 from pot
rockwhack: doesn't show hand 
*** SUMMARY ***
Total pot $2.25 | Rake $0.10 
Board [4c 4d 8h]
Seat 1: JMAC60 (big blind) folded on the Flop
Seat 2: deepspace68 folded before Flop (didn't bet)
Seat 3: Rockush420 folded before Flop (didn't bet)
Seat 4: Diego pb folded before Flop (didn't bet)
Seat 5: rockwhack collected ($2.15)
Seat 6: finztothelft folded before Flop (didn't bet)
Seat 7: Marcoj916 folded before Flop (didn't bet)
Seat 8: 1,1,2,3,5 folded before Flop (didn't bet)
Seat 9: Haek82 (button) folded before Flop (didn't bet)
Seat 10: 1nyyfan (small blind) folded before Flop



PokerStars Game #6807257576:  Hold'em Limit ($0.50/$1.00) - 2006/10/28 - 20:24:31 (ET)
Table 'Tanina' 10-max Seat #10 is the button
Seat 1: JMAC60 ($26.50 in chips) 
Seat 2: deepspace68 ($42.05 in chips) 
Seat 3: Rockush420 ($14.75 in chips) 
Seat 4: Diego pb ($18.15 in chips) 
Seat 5: rockwhack ($28.15 in chips) 
Seat 6: finztothelft ($19.95 in chips) 
Seat 7: Marcoj916 ($46.25 in chips) 
Seat 8: 1,1,2,3,5 ($16.95 in chips) 
Seat 9: Haek82 ($29.70 in chips) 
Seat 10: 1nyyfan ($16.25 in chips) 
JMAC60: posts small blind $0.25
deepspace68: posts big blind $0.50
*** HOLE CARDS ***
Dealt to 1,1,2,3,5 [Qd 3c]
Rockush420: folds 
Diego pb: folds 
rockwhack: folds 
finztothelft: folds 
Marcoj916: folds 
1,1,2,3,5: folds 
Haek82: folds 
1nyyfan: calls $0.50
JMAC60: folds 
deepspace68: checks 
*** FLOP *** [6c 6d Jh]
deepspace68: checks 
1nyyfan: bets $0.50
deepspace68: folds 
1nyyfan collected $1.20 from pot
1nyyfan: doesn't show hand 
*** SUMMARY ***
Total pot $1.25 | Rake $0.05 
Board [6c 6d Jh]
Seat 1: JMAC60 (small blind) folded before Flop
Seat 2: deepspace68 (big blind) folded on the Flop
Seat 3: Rockush420 folded before Flop (didn't bet)
Seat 4: Diego pb folded before Flop (didn't bet)
Seat 5: rockwhack folded before Flop (didn't bet)
Seat 6: finztothelft folded before Flop (didn't bet)
Seat 7: Marcoj916 folded before Flop (didn't bet)
Seat 8: 1,1,2,3,5 folded before Flop (didn't bet)
Seat 9: Haek82 folded before Flop (didn't bet)
Seat 10: 1nyyfan (button) collected ($1.20)



PokerStars Game #6807264599:  Hold'em Limit ($0.50/$1.00) - 2006/10/28 - 20:25:06 (ET)
Table 'Tanina' 10-max Seat #1 is the button
Seat 1: JMAC60 ($26.25 in chips) 
Seat 2: deepspace68 ($41.55 in chips) 
Seat 3: Rockush420 ($14.75 in chips) 
Seat 4: Diego pb ($18.15 in chips) 
Seat 5: rockwhack ($28.15 in chips) 
Seat 6: finztothelft ($19.95 in chips) 
Seat 7: Marcoj916 ($46.25 in chips) 
Seat 8: 1,1,2,3,5 ($16.95 in chips) 
Seat 9: Haek82 ($29.70 in chips) 
Seat 10: 1nyyfan ($16.95 in chips) 
deepspace68: posts small blind $0.25
Rockush420: posts big blind $0.50
*** HOLE CARDS ***
Dealt to 1,1,2,3,5 [Jh 6h]
Diego pb: folds 
rockwhack: folds 
finztothelft: calls $0.50
Marcoj916: folds 
1,1,2,3,5: folds 
Haek82: folds 
1nyyfan: calls $0.50
JMAC60: calls $0.50
deepspace68: folds 
Rockush420: checks 
*** FLOP *** [Jc Kc Qc]
Rockush420: checks 
finztothelft: bets $0.50
1nyyfan: folds 
JMAC60: raises $0.50 to $1
Rockush420: folds 
finztothelft: calls $0.50
*** TURN *** [Jc Kc Qc] [Ts]
finztothelft: checks 
JMAC60: bets $1
finztothelft: calls $1
*** RIVER *** [Jc Kc Qc Ts] [6c]
finztothelft: checks 
JMAC60: checks 
*** SHOW DOWN ***
finztothelft: shows [Jd Td] (two pair, Jacks and Tens)
JMAC60: mucks hand 
finztothelft collected $5.95 from pot
*** SUMMARY ***
Total pot $6.25 | Rake $0.30 
Board [Jc Kc Qc Ts 6c]
Seat 1: JMAC60 (button) mucked [8h Kh]
Seat 2: deepspace68 (small blind) folded before Flop
Seat 3: Rockush420 (big blind) folded on the Flop
Seat 4: Diego pb folded before Flop (didn't bet)
Seat 5: rockwhack folded before Flop (didn't bet)
Seat 6: finztothelft showed [Jd Td] and won ($5.95) with two pair, Jacks and Tens
Seat 7: Marcoj916 folded before Flop (didn't bet)
Seat 8: 1,1,2,3,5 folded before Flop (didn't bet)
Seat 9: Haek82 folded before Flop (didn't bet)
Seat 10: 1nyyfan folded on the Flop



PokerStars Game #6807275313:  Hold'em Limit ($0.50/$1.00) - 2006/10/28 - 20:26:00 (ET)
Table 'Tanina' 10-max Seat #2 is the button
Seat 1: JMAC60 ($23.75 in chips) 
Seat 2: deepspace68 ($41.30 in chips) 
Seat 3: Rockush420 ($14.25 in chips) 
Seat 4: Diego pb ($18.15 in chips) 
Seat 5: rockwhack ($28.15 in chips) 
Seat 6: finztothelft ($23.40 in chips) 
Seat 7: Marcoj916 ($46.25 in chips) 
Seat 8: 1,1,2,3,5 ($16.95 in chips) 
Seat 9: Haek82 ($29.70 in chips) 
Seat 10: 1nyyfan ($16.45 in chips) 
Rockush420: posts small blind $0.25
Diego pb: posts big blind $0.50
*** HOLE CARDS ***
Dealt to 1,1,2,3,5 [Qs 4d]
rockwhack: folds 
finztothelft: folds 
Marcoj916: folds 
1,1,2,3,5: folds 
Haek82: folds 
1nyyfan: folds 
rockwhack leaves the table
JMAC60: raises $0.50 to $1
deepspace68: folds 
Rockush420: folds 
Diego pb: calls $0.50
*** FLOP *** [Js 2c Td]
dsa8088 joins the table at seat #5 
Diego pb: bets $0.50
JMAC60: raises $0.50 to $1
Diego pb: calls $0.50
*** TURN *** [Js 2c Td] [5h]
Diego pb: checks 
JMAC60: bets $1
Diego pb: raises $1 to $2
JMAC60: calls $1
*** RIVER *** [Js 2c Td 5h] [As]
Diego pb: bets $1
JMAC60: calls $1
*** SHOW DOWN ***
Diego pb: shows [5s 5c] (three of a kind, Fives)
JMAC60: mucks hand 
Diego pb collected $9.80 from pot
*** SUMMARY ***
Total pot $10.25 | Rake $0.45 
Board [Js 2c Td 5h As]
Seat 1: JMAC60 mucked [8s Ad]
Seat 2: deepspace68 (button) folded before Flop (didn't bet)
Seat 3: Rockush420 (small blind) folded before Flop
Seat 4: Diego pb (big blind) showed [5s 5c] and won ($9.80) with three of a kind, Fives
Seat 5: rockwhack folded before Flop (didn't bet)
Seat 6: finztothelft folded before Flop (didn't bet)
Seat 7: Marcoj916 folded before Flop (didn't bet)
Seat 8: 1,1,2,3,5 folded before Flop (didn't bet)
Seat 9: Haek82 folded before Flop (didn't bet)
Seat 10: 1nyyfan folded before Flop (didn't bet)



PokerStars Game #6807282536:  Hold'em Limit ($0.50/$1.00) - 2006/10/28 - 20:26:37 (ET)
Table 'Tanina' 10-max Seat #3 is the button
Seat 1: JMAC60 ($18.75 in chips) 
Seat 2: deepspace68 ($41.30 in chips) 
Seat 3: Rockush420 ($14 in chips) 
Seat 4: Diego pb ($22.95 in chips) 
Seat 5: dsa8088 ($20 in chips) 
Seat 6: finztothelft ($23.40 in chips) 
Seat 7: Marcoj916 ($46.25 in chips) 
Seat 8: 1,1,2,3,5 ($16.95 in chips) 
Seat 9: Haek82 ($29.70 in chips) 
Seat 10: 1nyyfan ($16.45 in chips) 
Diego pb: posts small blind $0.25
dsa8088: posts big blind $0.50
*** HOLE CARDS ***
Dealt to 1,1,2,3,5 [8s 4d]
finztothelft: folds 
Marcoj916: folds 
1,1,2,3,5: folds 
Haek82: folds 
1nyyfan: folds 
JMAC60: folds 
deepspace68: folds 
Rockush420: raises $0.50 to $1
Diego pb: folds 
dsa8088: folds 
Rockush420 collected $1.25 from pot
*** SUMMARY ***
Total pot $1.25 | Rake $0 
Seat 1: JMAC60 folded before Flop (didn't bet)
Seat 2: deepspace68 folded before Flop (didn't bet)
Seat 3: Rockush420 (button) collected ($1.25)
Seat 4: Diego pb (small blind) folded before Flop
Seat 5: dsa8088 (big blind) folded before Flop
Seat 6: finztothelft folded before Flop (didn't bet)
Seat 7: Marcoj916 folded before Flop (didn't bet)
Seat 8: 1,1,2,3,5 folded before Flop (didn't bet)
Seat 9: Haek82 folded before Flop (didn't bet)
Seat 10: 1nyyfan folded before Flop (didn't bet)



PokerStars Game #6807290231:  Hold'em Limit ($0.50/$1.00) - 2006/10/28 - 20:27:16 (ET)
Table 'Tanina' 10-max Seat #4 is the button
Seat 1: JMAC60 ($18.75 in chips) 
Seat 2: deepspace68 ($41.30 in chips) 
Seat 3: Rockush420 ($14.75 in chips) 
Seat 4: Diego pb ($22.70 in chips) 
Seat 5: dsa8088 ($19.50 in chips) 
Seat 6: finztothelft ($23.40 in chips) 
Seat 7: Marcoj916 ($46.25 in chips) 
Seat 8: 1,1,2,3,5 ($16.95 in chips) 
Seat 9: Haek82 ($29.70 in chips) 
Seat 10: 1nyyfan ($16.45 in chips) 
dsa8088: posts small blind $0.25
finztothelft: posts big blind $0.50
*** HOLE CARDS ***
Dealt to 1,1,2,3,5 [Ah 2s]
Marcoj916: folds 
1,1,2,3,5: folds 
Haek82: calls $0.50
1nyyfan: folds 
JMAC60: calls $0.50
deepspace68: folds 
Rockush420: folds 
Diego pb: folds 
dsa8088: folds 
finztothelft: raises $0.50 to $1
Haek82: raises $0.50 to $1.50
JMAC60: calls $1
finztothelft: raises $0.50 to $2
Betting is capped
Haek82: calls $0.50
JMAC60: calls $0.50
*** FLOP *** [3s 7c 9d]
finztothelft: bets $0.50
Haek82: calls $0.50
JMAC60: calls $0.50
*** TURN *** [3s 7c 9d] [4s]
finztothelft: bets $1
Haek82: raises $1 to $2
JMAC60: folds 
finztothelft: raises $1 to $3
Haek82: calls $1
*** RIVER *** [3s 7c 9d 4s] [5d]
finztothelft: checks 
Haek82: checks 
*** SHOW DOWN ***
finztothelft: shows [Ac Ad] (a pair of Aces)
Haek82: shows [Kd Ks] (a pair of Kings)
finztothelft collected $13.25 from pot
*** SUMMARY ***
Total pot $13.75 | Rake $0.50 
Board [3s 7c 9d 4s 5d]
Seat 1: JMAC60 folded on the Turn
Seat 2: deepspace68 folded before Flop (didn't bet)
Seat 3: Rockush420 folded before Flop (didn't bet)
Seat 4: Diego pb (button) folded before Flop (didn't bet)
Seat 5: dsa8088 (small blind) folded before Flop
Seat 6: finztothelft (big blind) showed [Ac Ad] and won ($13.25) with a pair of Aces
Seat 7: Marcoj916 folded before Flop (didn't bet)
Seat 8: 1,1,2,3,5 folded before Flop (didn't bet)
Seat 9: Haek82 showed [Kd Ks] and lost with a pair of Kings
Seat 10: 1nyyfan folded before Flop (didn't bet)



PokerStars Game #6807303734:  Hold'em Limit ($0.50/$1.00) - 2006/10/28 - 20:28:24 (ET)
Table 'Tanina' 10-max Seat #5 is the button
Seat 1: JMAC60 ($16.25 in chips) 
Seat 2: deepspace68 ($41.30 in chips) 
Seat 3: Rockush420 ($14.75 in chips) 
Seat 4: Diego pb ($22.70 in chips) 
Seat 5: dsa8088 ($19.25 in chips) 
Seat 6: finztothelft ($31.15 in chips) 
Seat 7: Marcoj916 ($46.25 in chips) 
Seat 8: 1,1,2,3,5 ($16.95 in chips) 
Seat 9: Haek82 ($24.20 in chips) 
Seat 10: 1nyyfan ($16.45 in chips) 
finztothelft: posts small blind $0.25
Marcoj916: posts big blind $0.50
*** HOLE CARDS ***
Dealt to 1,1,2,3,5 [3c Td]
Diego pb said, "unreal"
1,1,2,3,5: folds 
Haek82: raises $0.50 to $1
1nyyfan: folds 
JMAC60: folds 
deepspace68: folds 
Rockush420: folds 
Diego pb: folds 
dsa8088: folds 
finztothelft: folds 
Marcoj916: folds 
Haek82 collected $1.25 from pot
*** SUMMARY ***
Total pot $1.25 | Rake $0 
Seat 1: JMAC60 folded before Flop (didn't bet)
Seat 2: deepspace68 folded before Flop (didn't bet)
Seat 3: Rockush420 folded before Flop (didn't bet)
Seat 4: Diego pb folded before Flop (didn't bet)
Seat 5: dsa8088 (button) folded before Flop (didn't bet)
Seat 6: finztothelft (small blind) folded before Flop
Seat 7: Marcoj916 (big blind) folded before Flop
Seat 8: 1,1,2,3,5 folded before Flop (didn't bet)
Seat 9: Haek82 collected ($1.25)
Seat 10: 1nyyfan folded before Flop (didn't bet)



PokerStars Game #6807308841:  Hold'em Limit ($0.50/$1.00) - 2006/10/28 - 20:28:50 (ET)
Table 'Tanina' 10-max Seat #6 is the button
Seat 1: JMAC60 ($16.25 in chips) 
Seat 2: deepspace68 ($41.30 in chips) 
Seat 3: Rockush420 ($14.75 in chips) 
Seat 4: Diego pb ($22.70 in chips) 
Seat 5: dsa8088 ($19.25 in chips) 
Seat 6: finztothelft ($30.90 in chips) 
Seat 7: Marcoj916 ($45.75 in chips) 
Seat 8: 1,1,2,3,5 ($16.95 in chips) 
Seat 9: Haek82 ($24.95 in chips) 
Seat 10: 1nyyfan ($16.45 in chips) 
Marcoj916: posts small blind $0.25
1,1,2,3,5: posts big blind $0.50
*** HOLE CARDS ***
Dealt to 1,1,2,3,5 [7d 7c]
Haek82: folds 
1nyyfan: calls $0.50
JMAC60: folds 
deepspace68: calls $0.50
Rockush420: folds 
Diego pb: calls $0.50
dsa8088: folds 
finztothelft: folds 
Marcoj916: calls $0.25
1,1,2,3,5: checks 
*** FLOP *** [Jh 8d 9d]
Marcoj916: checks 
1,1,2,3,5: checks 
1nyyfan: checks 
deepspace68: checks 
Diego pb: bets $0.50
Marcoj916: calls $0.50
1,1,2,3,5: folds 
1nyyfan: folds 
deepspace68: calls $0.50
*** TURN *** [Jh 8d 9d] [Td]
Marcoj916: bets $1
deepspace68: folds 
Diego pb: calls $1
*** RIVER *** [Jh 8d 9d Td] [4d]
Marcoj916: bets $1
Diego pb: calls $1
*** SHOW DOWN ***
Marcoj916: shows [Qd Jc] (a flush, Queen high)
Diego pb: mucks hand 
Marcoj916 collected $7.65 from pot
*** SUMMARY ***
Total pot $8 | Rake $0.35 
Board [Jh 8d 9d Td 4d]
Seat 1: JMAC60 folded before Flop (didn't bet)
Seat 2: deepspace68 folded on the Turn
Seat 3: Rockush420 folded before Flop (didn't bet)
Seat 4: Diego pb mucked [Qh Ts]
Seat 5: dsa8088 folded before Flop (didn't bet)
Seat 6: finztothelft (button) folded before Flop (didn't bet)
Seat 7: Marcoj916 (small blind) showed [Qd Jc] and won ($7.65) with a flush, Queen high
Seat 8: 1,1,2,3,5 (big blind) folded on the Flop
Seat 9: Haek82 folded before Flop (didn't bet)
Seat 10: 1nyyfan folded on the Flop



PokerStars Game #6807323633:  Hold'em Limit ($0.50/$1.00) - 2006/10/28 - 20:30:00 (ET)
Table 'Tanina' 10-max Seat #7 is the button
Seat 1: JMAC60 ($16.25 in chips) 
Seat 2: deepspace68 ($40.30 in chips) 
Seat 3: Rockush420 ($14.75 in chips) 
Seat 4: Diego pb ($19.70 in chips) 
Seat 5: dsa8088 ($19.25 in chips) 
Seat 6: finztothelft ($30.90 in chips) 
Seat 7: Marcoj916 ($50.40 in chips) 
Seat 8: 1,1,2,3,5 ($16.45 in chips) 
Seat 9: Haek82 ($24.95 in chips) 
Seat 10: 1nyyfan ($15.95 in chips) 
1,1,2,3,5: posts small blind $0.25
Haek82: posts big blind $0.50
*** HOLE CARDS ***
Dealt to 1,1,2,3,5 [Jh 6h]
1nyyfan: folds 
JMAC60: raises $0.50 to $1
deepspace68: folds 
Rockush420: folds 
Diego pb said, "lol nothing like flopping he straight and getting sucked out"
Diego pb: calls $1
dsa8088: folds 
finztothelft: folds 
Marcoj916: folds 
1,1,2,3,5: folds 
Haek82: folds 
*** FLOP *** [2c Ac Kc]
JMAC60: bets $0.50
Diego pb: folds 
JMAC60 collected $2.65 from pot
JMAC60: doesn't show hand 
*** SUMMARY ***
Total pot $2.75 | Rake $0.10 
Board [2c Ac Kc]
Seat 1: JMAC60 collected ($2.65)
Seat 2: deepspace68 folded before Flop (didn't bet)
Seat 3: Rockush420 folded before Flop (didn't bet)
Seat 4: Diego pb folded on the Flop
Seat 5: dsa8088 folded before Flop (didn't bet)
Seat 6: finztothelft folded before Flop (didn't bet)
Seat 7: Marcoj916 (button) folded before Flop (didn't bet)
Seat 8: 1,1,2,3,5 (small blind) folded before Flop
Seat 9: Haek82 (big blind) folded before Flop
Seat 10: 1nyyfan folded before Flop (didn't bet)



PokerStars Game #6807330302:  Hold'em Limit ($0.50/$1.00) - 2006/10/28 - 20:30:34 (ET)
Table 'Tanina' 10-max Seat #8 is the button
Seat 1: JMAC60 ($17.90 in chips) 
Seat 2: deepspace68 ($40.30 in chips) 
Seat 3: Rockush420 ($14.75 in chips) 
Seat 4: Diego pb ($18.70 in chips) 
Seat 5: dsa8088 ($19.25 in chips) 
Seat 6: finztothelft ($30.90 in chips) 
Seat 7: Marcoj916 ($50.40 in chips) 
Seat 8: 1,1,2,3,5 ($16.20 in chips) 
Seat 9: Haek82 ($24.45 in chips) 
Seat 10: 1nyyfan ($15.95 in chips) 
Haek82: posts small blind $0.25
1nyyfan: posts big blind $0.50
*** HOLE CARDS ***
Dealt to 1,1,2,3,5 [Qs 5c]
JMAC60: folds 
deepspace68: folds 
Rockush420: raises $0.50 to $1
Diego pb: folds 
dsa8088: folds 
finztothelft: folds 
Marcoj916: folds 
1,1,2,3,5: folds 
Haek82: folds 
1nyyfan: calls $0.50
*** FLOP *** [Th 7c Ts]
1nyyfan: checks 
Marcoj916 said, "first time, huh?"
Rockush420: bets $0.50
1nyyfan: calls $0.50
*** TURN *** [Th 7c Ts] [Jc]
1nyyfan: checks 
Rockush420: checks 
*** RIVER *** [Th 7c Ts Jc] [3d]
1nyyfan: checks 
Rockush420: checks 
*** SHOW DOWN ***
1nyyfan: shows [9h Js] (two pair, Jacks and Tens)
finztothelft said, "lol"
Rockush420: mucks hand 
1nyyfan collected $3.10 from pot
*** SUMMARY ***
Total pot $3.25 | Rake $0.15 
Board [Th 7c Ts Jc 3d]
Seat 1: JMAC60 folded before Flop (didn't bet)
Seat 2: deepspace68 folded before Flop (didn't bet)
Seat 3: Rockush420 mucked [As Qc]
Seat 4: Diego pb folded before Flop (didn't bet)
Seat 5: dsa8088 folded before Flop (didn't bet)
Seat 6: finztothelft folded before Flop (didn't bet)
Seat 7: Marcoj916 folded before Flop (didn't bet)
Seat 8: 1,1,2,3,5 (button) folded before Flop (didn't bet)
Seat 9: Haek82 (small blind) folded before Flop
Seat 10: 1nyyfan (big blind) showed [9h Js] and won ($3.10) with two pair, Jacks and Tens



PokerStars Game #6807340390:  Hold'em Limit ($0.50/$1.00) - 2006/10/28 - 20:31:23 (ET)
Table 'Tanina' 10-max Seat #9 is the button
Seat 1: JMAC60 ($17.90 in chips) 
Seat 2: deepspace68 ($40.30 in chips) 
Seat 3: Rockush420 ($13.25 in chips) 
Seat 4: Diego pb ($18.70 in chips) 
Seat 5: dsa8088 ($19.25 in chips) 
Seat 6: finztothelft ($30.90 in chips) 
Seat 7: Marcoj916 ($50.40 in chips) 
Seat 8: 1,1,2,3,5 ($16.20 in chips) 
Seat 9: Haek82 ($24.20 in chips) 
Seat 10: 1nyyfan ($17.55 in chips) 
1nyyfan: posts small blind $0.25
JMAC60: posts big blind $0.50
*** HOLE CARDS ***
Dealt to 1,1,2,3,5 [3c 2s]
Diego pb said, "lol"
Marcoj916 said, "lol"
deepspace68: folds 
Rockush420: folds 
Diego pb: folds 
dsa8088: folds 
finztothelft: calls $0.50
Marcoj916: raises $0.50 to $1
1,1,2,3,5: folds 
Haek82: folds 
1nyyfan: calls $0.75
JMAC60: folds 
Diego pb said, "man i am going to use that one"
finztothelft: calls $0.50
*** FLOP *** [3h Ad 6s]
1nyyfan: checks 
finztothelft: checks 
Marcoj916: bets $0.50
1nyyfan: folds 
finztothelft: folds 
Marcoj916 collected $3.35 from pot
Marcoj916: doesn't show hand 
*** SUMMARY ***
Total pot $3.50 | Rake $0.15 
Board [3h Ad 6s]
Seat 1: JMAC60 (big blind) folded before Flop
Seat 2: deepspace68 folded before Flop (didn't bet)
Seat 3: Rockush420 folded before Flop (didn't bet)
Seat 4: Diego pb folded before Flop (didn't bet)
Seat 5: dsa8088 folded before Flop (didn't bet)
Seat 6: finztothelft folded on the Flop
Seat 7: Marcoj916 collected ($3.35)
Seat 8: 1,1,2,3,5 folded before Flop (didn't bet)
Seat 9: Haek82 (button) folded before Flop (didn't bet)
Seat 10: 1nyyfan (small blind) folded on the Flop



PokerStars Game #6807348502:  Hold'em Limit ($0.50/$1.00) - 2006/10/28 - 20:32:02 (ET)
Table 'Tanina' 10-max Seat #10 is the button
Seat 1: JMAC60 ($17.40 in chips) 
Seat 2: deepspace68 ($40.30 in chips) 
Seat 3: Rockush420 ($13.25 in chips) 
Seat 4: Diego pb ($18.70 in chips) 
Seat 5: dsa8088 ($19.25 in chips) 
Seat 6: finztothelft ($29.90 in chips) 
Seat 7: Marcoj916 ($52.75 in chips) 
Seat 8: 1,1,2,3,5 ($16.20 in chips) 
Seat 9: Haek82 ($24.20 in chips) 
Seat 10: 1nyyfan ($16.55 in chips) 
JMAC60: posts small blind $0.25
deepspace68: posts big blind $0.50
*** HOLE CARDS ***
Dealt to 1,1,2,3,5 [Kd Ac]
Rockush420: folds 
Diego pb: calls $0.50
dsa8088: calls $0.50
finztothelft: folds 
Marcoj916: folds 
1,1,2,3,5: raises $0.50 to $1
Haek82: folds 
1nyyfan: folds 
JMAC60: folds 
deepspace68: folds 
Diego pb: calls $0.50
dsa8088: calls $0.50
*** FLOP *** [Js Tc 9c]
Diego pb: bets $0.50
dsa8088: calls $0.50
1,1,2,3,5: calls $0.50
*** TURN *** [Js Tc 9c] [Jc]
Diego pb: bets $1
dsa8088: calls $1
1,1,2,3,5: calls $1
*** RIVER *** [Js Tc 9c Jc] [4c]
Diego pb: checks 
dsa8088: checks 
1,1,2,3,5: bets $1
Diego pb: calls $1
dsa8088: folds 
*** SHOW DOWN ***
1,1,2,3,5: shows [Kd Ac] (a flush, Ace high)
Diego pb: mucks hand 
1,1,2,3,5 collected $9.80 from pot
*** SUMMARY ***
Total pot $10.25 | Rake $0.45 
Board [Js Tc 9c Jc 4c]
Seat 1: JMAC60 (small blind) folded before Flop
Seat 2: deepspace68 (big blind) folded before Flop
Seat 3: Rockush420 folded before Flop (didn't bet)
Seat 4: Diego pb mucked [Qc Td]
Seat 5: dsa8088 folded on the River
Seat 6: finztothelft folded before Flop (didn't bet)
Seat 7: Marcoj916 folded before Flop (didn't bet)
Seat 8: 1,1,2,3,5 showed [Kd Ac] and won ($9.80) with a flush, Ace high
Seat 9: Haek82 folded before Flop (didn't bet)
Seat 10: 1nyyfan (button) folded before Flop (didn't bet)



PokerStars Game #6807359689:  Hold'em Limit ($0.50/$1.00) - 2006/10/28 - 20:32:57 (ET)
Table 'Tanina' 10-max Seat #1 is the button
Seat 1: JMAC60 ($17.15 in chips) 
Seat 2: deepspace68 ($39.80 in chips) 
Seat 3: Rockush420 ($13.25 in chips) 
Seat 4: Diego pb ($15.20 in chips) 
Seat 5: dsa8088 ($16.75 in chips) 
Seat 6: finztothelft ($29.90 in chips) 
Seat 7: Marcoj916 ($52.75 in chips) 
Seat 8: 1,1,2,3,5 ($22.50 in chips) 
Seat 9: Haek82 ($24.20 in chips) 
Seat 10: 1nyyfan ($16.55 in chips) 
deepspace68: posts small blind $0.25
Rockush420: posts big blind $0.50
*** HOLE CARDS ***
Dealt to 1,1,2,3,5 [Jh Qs]
Diego pb said, "hahaha again"
Diego pb: folds 
dsa8088: folds 
finztothelft: calls $0.50
Marcoj916: calls $0.50
1,1,2,3,5: folds 
Haek82: folds 
1nyyfan: raises $0.50 to $1
JMAC60: folds 
deepspace68: folds 
Rockush420: calls $0.50
finztothelft: calls $0.50
Marcoj916: calls $0.50
*** FLOP *** [Ac Kc Jd]
Rockush420: checks 
finztothelft: bets $0.50
Marcoj916: folds 
1nyyfan: raises $0.50 to $1
Rockush420: folds 
finztothelft: calls $0.50
*** TURN *** [Ac Kc Jd] [2h]
finztothelft: checks 
1nyyfan: bets $1
finztothelft: calls $1
*** RIVER *** [Ac Kc Jd 2h] [Kd]
finztothelft: checks 
1nyyfan: bets $1
finztothelft: calls $1
*** SHOW DOWN ***
1nyyfan: shows [Ks Kh] (four of a kind, Kings)
finztothelft: mucks hand 
1nyyfan collected $9.80 from pot
Marcoj916 said, "vnh"
finztothelft said, "vn"
*** SUMMARY ***
Total pot $10.25 | Rake $0.45 
Board [Ac Kc Jd 2h Kd]
Seat 1: JMAC60 (button) folded before Flop (didn't bet)
Seat 2: deepspace68 (small blind) folded before Flop
Seat 3: Rockush420 (big blind) folded on the Flop
Seat 4: Diego pb folded before Flop (didn't bet)
Seat 5: dsa8088 folded before Flop (didn't bet)
Seat 6: finztothelft mucked [Tc Ad]
Seat 7: Marcoj916 folded on the Flop
Seat 8: 1,1,2,3,5 folded before Flop (didn't bet)
Seat 9: Haek82 folded before Flop (didn't bet)
Seat 10: 1nyyfan showed [Ks Kh] and won ($9.80) with four of a kind, Kings



PokerStars Game #6807372525:  Hold'em Limit ($0.50/$1.00) - 2006/10/28 - 20:33:59 (ET)
Table 'Tanina' 10-max Seat #2 is the button
Seat 1: JMAC60 ($17.15 in chips) 
Seat 2: deepspace68 ($39.55 in chips) 
Seat 3: Rockush420 ($12.25 in chips) 
Seat 4: Diego pb ($15.20 in chips) 
Seat 5: dsa8088 ($16.75 in chips) 
Seat 6: finztothelft ($25.90 in chips) 
Seat 7: Marcoj916 ($51.75 in chips) 
Seat 8: 1,1,2,3,5 ($22.50 in chips) 
Seat 9: Haek82 ($24.20 in chips) 
Seat 10: 1nyyfan ($22.35 in chips) 
Rockush420: posts small blind $0.25
Diego pb: posts big blind $0.50
*** HOLE CARDS ***
Dealt to 1,1,2,3,5 [3h 9h]
1nyyfan said, "ty"
dsa8088: folds 
finztothelft: folds 
Marcoj916: folds 
1,1,2,3,5: folds 
Haek82: folds 
1nyyfan: folds 
JMAC60: folds 
deepspace68: calls $0.50
Rockush420: folds 
Diego pb: checks 
*** FLOP *** [Qs 2c 3c]
Diego pb: bets $0.50
deepspace68: calls $0.50
*** TURN *** [Qs 2c 3c] [Jd]
Diego pb: bets $1
deepspace68: calls $1
*** RIVER *** [Qs 2c 3c Jd] [Ac]
Diego pb: checks 
deepspace68: checks 
*** SHOW DOWN ***
Diego pb: shows [Qh 7h] (a pair of Queens)
deepspace68: mucks hand 
Diego pb collected $4.05 from pot
*** SUMMARY ***
Total pot $4.25 | Rake $0.20 
Board [Qs 2c 3c Jd Ac]
Seat 1: JMAC60 folded before Flop (didn't bet)
Seat 2: deepspace68 (button) mucked [Ks Js]
Seat 3: Rockush420 (small blind) folded before Flop
Seat 4: Diego pb (big blind) showed [Qh 7h] and won ($4.05) with a pair of Queens
Seat 5: dsa8088 folded before Flop (didn't bet)
Seat 6: finztothelft folded before Flop (didn't bet)
Seat 7: Marcoj916 folded before Flop (didn't bet)
Seat 8: 1,1,2,3,5 folded before Flop (didn't bet)
Seat 9: Haek82 folded before Flop (didn't bet)
Seat 10: 1nyyfan folded before Flop (didn't bet)



PokerStars Game #6807385869:  Hold'em Limit ($0.50/$1.00) - 2006/10/28 - 20:35:04 (ET)
Table 'Tanina' 10-max Seat #3 is the button
Seat 1: JMAC60 ($17.15 in chips) 
Seat 2: deepspace68 ($37.55 in chips) 
Seat 3: Rockush420 ($12 in chips) 
Seat 4: Diego pb ($17.25 in chips) 
Seat 5: dsa8088 ($16.75 in chips) 
Seat 6: finztothelft ($25.90 in chips) 
Seat 7: Marcoj916 ($51.75 in chips) 
Seat 8: 1,1,2,3,5 ($22.50 in chips) 
Seat 9: Haek82 ($24.20 in chips) 
Seat 10: 1nyyfan ($22.35 in chips) 
Diego pb: posts small blind $0.25
dsa8088: posts big blind $0.50
*** HOLE CARDS ***
Dealt to 1,1,2,3,5 [2h Qc]
finztothelft: folds 
Marcoj916: folds 
1,1,2,3,5: folds 
Haek82: folds 
1nyyfan: calls $0.50
JMAC60: folds 
deepspace68: calls $0.50
Rockush420: calls $0.50
Diego pb: folds 
dsa8088: checks 
*** FLOP *** [8d 3s 9h]
dsa8088: checks 
1nyyfan: checks 
deepspace68: checks 
Rockush420: bets $0.50
dsa8088: folds 
1nyyfan: folds 
deepspace68: folds 
Rockush420 collected $2.15 from pot
*** SUMMARY ***
Total pot $2.25 | Rake $0.10 
Board [8d 3s 9h]
Seat 1: JMAC60 folded before Flop (didn't bet)
Seat 2: deepspace68 folded on the Flop
Seat 3: Rockush420 (button) collected ($2.15)
Seat 4: Diego pb (small blind) folded before Flop
Seat 5: dsa8088 (big blind) folded on the Flop
Seat 6: finztothelft folded before Flop (didn't bet)
Seat 7: Marcoj916 folded before Flop (didn't bet)
Seat 8: 1,1,2,3,5 folded before Flop (didn't bet)
Seat 9: Haek82 folded before Flop (didn't bet)
Seat 10: 1nyyfan folded on the Flop



PokerStars Game #6807392810:  Hold'em Limit ($0.50/$1.00) - 2006/10/28 - 20:35:37 (ET)
Table 'Tanina' 10-max Seat #4 is the button
Seat 1: JMAC60 ($17.15 in chips) 
Seat 2: deepspace68 ($37.05 in chips) 
Seat 3: Rockush420 ($13.65 in chips) 
Seat 4: Diego pb ($17 in chips) 
Seat 5: dsa8088 ($16.25 in chips) 
Seat 6: finztothelft ($25.90 in chips) 
Seat 7: Marcoj916 ($51.75 in chips) 
Seat 8: 1,1,2,3,5 ($22.50 in chips) 
Seat 9: Haek82 ($24.20 in chips) 
Seat 10: 1nyyfan ($21.85 in chips) 
dsa8088: posts small blind $0.25
finztothelft: posts big blind $0.50
*** HOLE CARDS ***
Dealt to 1,1,2,3,5 [Ac 7s]
Marcoj916: folds 
1,1,2,3,5: folds 
Haek82: folds 
1nyyfan: folds 
JMAC60: folds 
deepspace68: calls $0.50
Rockush420: folds 
Diego pb: folds 
dsa8088: folds 
finztothelft: checks 
*** FLOP *** [7d Kc 5d]
finztothelft: checks 
deepspace68: bets $0.50
finztothelft: folds 
deepspace68 collected $1.20 from pot
*** SUMMARY ***
Total pot $1.25 | Rake $0.05 
Board [7d Kc 5d]
Seat 1: JMAC60 folded before Flop (didn't bet)
Seat 2: deepspace68 collected ($1.20)
Seat 3: Rockush420 folded before Flop (didn't bet)
Seat 4: Diego pb (button) folded before Flop (didn't bet)
Seat 5: dsa8088 (small blind) folded before Flop
Seat 6: finztothelft (big blind) folded on the Flop
Seat 7: Marcoj916 folded before Flop (didn't bet)
Seat 8: 1,1,2,3,5 folded before Flop (didn't bet)
Seat 9: Haek82 folded before Flop (didn't bet)
Seat 10: 1nyyfan folded before Flop (didn't bet)



PokerStars Game #6807399700:  Hold'em Limit ($0.50/$1.00) - 2006/10/28 - 20:36:11 (ET)
Table 'Tanina' 10-max Seat #5 is the button
Seat 1: JMAC60 ($17.15 in chips) 
Seat 2: deepspace68 ($37.75 in chips) 
Seat 3: Rockush420 ($13.65 in chips) 
Seat 4: Diego pb ($17 in chips) 
Seat 5: dsa8088 ($16 in chips) 
Seat 6: finztothelft ($25.40 in chips) 
Seat 7: Marcoj916 ($51.75 in chips) 
Seat 8: 1,1,2,3,5 ($22.50 in chips) 
Seat 9: Haek82 ($24.20 in chips) 
Seat 10: 1nyyfan ($21.85 in chips) 
finztothelft: posts small blind $0.25
Marcoj916: posts big blind $0.50
*** HOLE CARDS ***
Dealt to 1,1,2,3,5 [Jh Qc]
1,1,2,3,5: folds 
Haek82: folds 
1nyyfan: folds 
JMAC60: folds 
deepspace68: folds 
Rockush420: folds 
Diego pb: folds 
dsa8088: raises $0.50 to $1
finztothelft: folds 
Marcoj916: calls $0.50
*** FLOP *** [Kd Qh 5h]
Marcoj916: checks 
dsa8088: bets $0.50
Marcoj916: raises $0.50 to $1
dsa8088: calls $0.50
*** TURN *** [Kd Qh 5h] [Qs]
Marcoj916: bets $1
dsa8088: raises $1 to $2
Marcoj916: folds 
dsa8088 collected $5.95 from pot
dsa8088: doesn't show hand 
*** SUMMARY ***
Total pot $6.25 | Rake $0.30 
Board [Kd Qh 5h Qs]
Seat 1: JMAC60 folded before Flop (didn't bet)
Seat 2: deepspace68 folded before Flop (didn't bet)
Seat 3: Rockush420 folded before Flop (didn't bet)
Seat 4: Diego pb folded before Flop (didn't bet)
Seat 5: dsa8088 (button) collected ($5.95)
Seat 6: finztothelft (small blind) folded before Flop
Seat 7: Marcoj916 (big blind) folded on the Turn
Seat 8: 1,1,2,3,5 folded before Flop (didn't bet)
Seat 9: Haek82 folded before Flop (didn't bet)
Seat 10: 1nyyfan folded before Flop (didn't bet)



PokerStars Game #6807409608:  Hold'em Limit ($0.50/$1.00) - 2006/10/28 - 20:36:59 (ET)
Table 'Tanina' 10-max Seat #6 is the button
Seat 1: JMAC60 ($17.15 in chips) 
Seat 2: deepspace68 ($37.75 in chips) 
Seat 3: Rockush420 ($13.65 in chips) 
Seat 4: Diego pb ($17 in chips) 
Seat 5: dsa8088 ($18.95 in chips) 
Seat 6: finztothelft ($25.15 in chips) 
Seat 7: Marcoj916 ($48.75 in chips) 
Seat 8: 1,1,2,3,5 ($22.50 in chips) 
Seat 9: Haek82 ($24.20 in chips) 
Seat 10: 1nyyfan ($21.85 in chips) 
Marcoj916: posts small blind $0.25
1,1,2,3,5: posts big blind $0.50
*** HOLE CARDS ***
Dealt to 1,1,2,3,5 [6d 7c]
Haek82: folds 
1nyyfan: folds 
JMAC60: folds 
deepspace68: folds 
Rockush420: calls $0.50
Diego pb: folds 
dsa8088: calls $0.50
finztothelft: folds 
Marcoj916: calls $0.25
1,1,2,3,5: checks 
*** FLOP *** [9h 2d Th]
Marcoj916: checks 
1,1,2,3,5: checks 
Rockush420: checks 
dsa8088: bets $0.50
Marcoj916: folds 
1,1,2,3,5: folds 
Rockush420: calls $0.50
*** TURN *** [9h 2d Th] [8c]
Rockush420: checks 
dsa8088: bets $1
Rockush420: folds 
dsa8088 collected $2.90 from pot
dsa8088: doesn't show hand 
*** SUMMARY ***
Total pot $3 | Rake $0.10 
Board [9h 2d Th 8c]
Seat 1: JMAC60 folded before Flop (didn't bet)
Seat 2: deepspace68 folded before Flop (didn't bet)
Seat 3: Rockush420 folded on the Turn
Seat 4: Diego pb folded before Flop (didn't bet)
Seat 5: dsa8088 collected ($2.90)
Seat 6: finztothelft (button) folded before Flop (didn't bet)
Seat 7: Marcoj916 (small blind) folded on the Flop
Seat 8: 1,1,2,3,5 (big blind) folded on the Flop
Seat 9: Haek82 folded before Flop (didn't bet)
Seat 10: 1nyyfan folded before Flop (didn't bet)



PokerStars Game #6807422742:  Hold'em Limit ($0.50/$1.00) - 2006/10/28 - 20:38:04 (ET)
Table 'Tanina' 10-max Seat #7 is the button
Seat 1: JMAC60 ($17.15 in chips) 
Seat 2: deepspace68 ($37.75 in chips) 
Seat 3: Rockush420 ($12.65 in chips) 
Seat 4: Diego pb ($17 in chips) 
Seat 5: dsa8088 ($20.85 in chips) 
Seat 6: finztothelft ($25.15 in chips) 
Seat 7: Marcoj916 ($48.25 in chips) 
Seat 8: 1,1,2,3,5 ($22 in chips) 
Seat 9: Haek82 ($24.20 in chips) 
Seat 10: 1nyyfan ($21.85 in chips) 
1,1,2,3,5: posts small blind $0.25
Haek82: posts big blind $0.50
*** HOLE CARDS ***
Dealt to 1,1,2,3,5 [5h 3h]
1nyyfan: folds 
JMAC60: folds 
deepspace68: calls $0.50
Rockush420: folds 
Diego pb: calls $0.50
dsa8088: folds 
finztothelft: folds 
Marcoj916: calls $0.50
1,1,2,3,5: folds 
Haek82: checks 
*** FLOP *** [9d 4s Kc]
Haek82: checks 
deepspace68: checks 
Diego pb: bets $0.50
Marcoj916: folds 
Haek82: calls $0.50
deepspace68: calls $0.50
*** TURN *** [9d 4s Kc] [Jh]
Haek82: checks 
deepspace68: checks 
Diego pb: checks 
*** RIVER *** [9d 4s Kc Jh] [8s]
Haek82: checks 
deepspace68: checks 
Diego pb: checks 
*** SHOW DOWN ***
Haek82: shows [9h Qc] (a pair of Nines)
deepspace68: mucks hand 
Diego pb: mucks hand 
Haek82 collected $3.60 from pot
*** SUMMARY ***
Total pot $3.75 | Rake $0.15 
Board [9d 4s Kc Jh 8s]
Seat 1: JMAC60 folded before Flop (didn't bet)
Seat 2: deepspace68 mucked [Ac 8c]
Seat 3: Rockush420 folded before Flop (didn't bet)
Seat 4: Diego pb mucked [Ah Th]
Seat 5: dsa8088 folded before Flop (didn't bet)
Seat 6: finztothelft folded before Flop (didn't bet)
Seat 7: Marcoj916 (button) folded on the Flop
Seat 8: 1,1,2,3,5 (small blind) folded before Flop
Seat 9: Haek82 (big blind) showed [9h Qc] and won ($3.60) with a pair of Nines
Seat 10: 1nyyfan folded before Flop (didn't bet)



PokerStars Game #6807433130:  Hold'em Limit ($0.50/$1.00) - 2006/10/28 - 20:38:54 (ET)
Table 'Tanina' 10-max Seat #8 is the button
Seat 1: JMAC60 ($17.15 in chips) 
Seat 2: deepspace68 ($36.75 in chips) 
Seat 3: Rockush420 ($12.65 in chips) 
Seat 4: Diego pb ($16 in chips) 
Seat 5: dsa8088 ($20.85 in chips) 
Seat 6: finztothelft ($25.15 in chips) 
Seat 7: Marcoj916 ($47.75 in chips) 
Seat 8: 1,1,2,3,5 ($21.75 in chips) 
Seat 9: Haek82 ($26.80 in chips) 
Seat 10: 1nyyfan ($21.85 in chips) 
Haek82: posts small blind $0.25
1nyyfan: posts big blind $0.50
*** HOLE CARDS ***
Dealt to 1,1,2,3,5 [Qc 4s]
JMAC60: folds 
deepspace68: folds 
Rockush420: folds 
Diego pb: raises $0.50 to $1
dsa8088: folds 
finztothelft: folds 
Marcoj916: folds 
1,1,2,3,5: folds 
Haek82: folds 
1nyyfan: calls $0.50
*** FLOP *** [Th Ks Ac]
1nyyfan: checks 
Diego pb: bets $0.50
1nyyfan: folds 
Diego pb collected $2.15 from pot
Diego pb: doesn't show hand 
*** SUMMARY ***
Total pot $2.25 | Rake $0.10 
Board [Th Ks Ac]
Seat 1: JMAC60 folded before Flop (didn't bet)
Seat 2: deepspace68 folded before Flop (didn't bet)
Seat 3: Rockush420 folded before Flop (didn't bet)
Seat 4: Diego pb collected ($2.15)
Seat 5: dsa8088 folded before Flop (didn't bet)
Seat 6: finztothelft folded before Flop (didn't bet)
Seat 7: Marcoj916 folded before Flop (didn't bet)
Seat 8: 1,1,2,3,5 (button) folded before Flop (didn't bet)
Seat 9: Haek82 (small blind) folded before Flop
Seat 10: 1nyyfan (big blind) folded on the Flop



PokerStars Game #6807439764:  Hold'em Limit ($0.50/$1.00) - 2006/10/28 - 20:39:27 (ET)
Table 'Tanina' 10-max Seat #9 is the button
Seat 1: JMAC60 ($17.15 in chips) 
Seat 2: deepspace68 ($36.75 in chips) 
Seat 3: Rockush420 ($12.65 in chips) 
Seat 4: Diego pb ($17.15 in chips) 
Seat 5: dsa8088 ($20.85 in chips) 
Seat 6: finztothelft ($25.15 in chips) 
Seat 7: Marcoj916 ($47.75 in chips) 
Seat 8: 1,1,2,3,5 ($21.75 in chips) 
Seat 9: Haek82 ($26.55 in chips) 
Seat 10: 1nyyfan ($20.85 in chips) 
1nyyfan: posts small blind $0.25
JMAC60: posts big blind $0.50
*** HOLE CARDS ***
Dealt to 1,1,2,3,5 [8h 9d]
deepspace68: folds 
Rockush420: calls $0.50
Diego pb: folds 
dsa8088: folds 
finztothelft: folds 
Marcoj916: folds 
1,1,2,3,5: folds 
Haek82: folds 
1nyyfan: calls $0.25
JMAC60: checks 
*** FLOP *** [3c Js 7h]
1nyyfan: bets $0.50
JMAC60: folds 
Rockush420: raises $0.50 to $1
1nyyfan: calls $0.50
*** TURN *** [3c Js 7h] [Qc]
1nyyfan: checks 
Rockush420: bets $1
1nyyfan: folds 
Rockush420 collected $3.35 from pot
*** SUMMARY ***
Total pot $3.50 | Rake $0.15 
Board [3c Js 7h Qc]
Seat 1: JMAC60 (big blind) folded on the Flop
Seat 2: deepspace68 folded before Flop (didn't bet)
Seat 3: Rockush420 collected ($3.35)
Seat 4: Diego pb folded before Flop (didn't bet)
Seat 5: dsa8088 folded before Flop (didn't bet)
Seat 6: finztothelft folded before Flop (didn't bet)
Seat 7: Marcoj916 folded before Flop (didn't bet)
Seat 8: 1,1,2,3,5 folded before Flop (didn't bet)
Seat 9: Haek82 (button) folded before Flop (didn't bet)
Seat 10: 1nyyfan (small blind) folded on the Turn



PokerStars Game #6807450089:  Hold'em Limit ($0.50/$1.00) - 2006/10/28 - 20:40:17 (ET)
Table 'Tanina' 10-max Seat #10 is the button
Seat 1: JMAC60 ($16.65 in chips) 
Seat 2: deepspace68 ($36.75 in chips) 
Seat 3: Rockush420 ($14.50 in chips) 
Seat 4: Diego pb ($17.15 in chips) 
Seat 5: dsa8088 ($20.85 in chips) 
Seat 6: finztothelft ($25.15 in chips) 
Seat 7: Marcoj916 ($47.75 in chips) 
Seat 8: 1,1,2,3,5 ($21.75 in chips) 
Seat 9: Haek82 ($26.55 in chips) 
Seat 10: 1nyyfan ($19.35 in chips) 
JMAC60: posts small blind $0.25
deepspace68: posts big blind $0.50
*** HOLE CARDS ***
Dealt to 1,1,2,3,5 [8c 2d]
Rockush420: folds 
Diego pb: folds 
dsa8088: folds 
finztothelft: folds 
Marcoj916: folds 
1,1,2,3,5: folds 
Haek82: folds 
1nyyfan: calls $0.50
JMAC60: folds 
deepspace68: raises $0.50 to $1
1nyyfan: calls $0.50
*** FLOP *** [4h 9d 2c]
deepspace68: bets $0.50
1nyyfan: folds 
deepspace68 collected $2.15 from pot
*** SUMMARY ***
Total pot $2.25 | Rake $0.10 
Board [4h 9d 2c]
Seat 1: JMAC60 (small blind) folded before Flop
Seat 2: deepspace68 (big blind) collected ($2.15)
Seat 3: Rockush420 folded before Flop (didn't bet)
Seat 4: Diego pb folded before Flop (didn't bet)
Seat 5: dsa8088 folded before Flop (didn't bet)
Seat 6: finztothelft folded before Flop (didn't bet)
Seat 7: Marcoj916 folded before Flop (didn't bet)
Seat 8: 1,1,2,3,5 folded before Flop (didn't bet)
Seat 9: Haek82 folded before Flop (didn't bet)
Seat 10: 1nyyfan (button) folded on the Flop



PokerStars Game #6807456308:  Hold'em Limit ($0.50/$1.00) - 2006/10/28 - 20:40:47 (ET)
Table 'Tanina' 10-max Seat #1 is the button
Seat 1: JMAC60 ($16.40 in chips) 
Seat 2: deepspace68 ($37.90 in chips) 
Seat 3: Rockush420 ($14.50 in chips) 
Seat 4: Diego pb ($17.15 in chips) 
Seat 5: dsa8088 ($20.85 in chips) 
Seat 6: finztothelft ($25.15 in chips) 
Seat 7: Marcoj916 ($47.75 in chips) 
Seat 8: 1,1,2,3,5 ($21.75 in chips) 
Seat 9: Haek82 ($26.55 in chips) 
Seat 10: 1nyyfan ($18.35 in chips) 
deepspace68: posts small blind $0.25
Rockush420: posts big blind $0.50
*** HOLE CARDS ***
Dealt to 1,1,2,3,5 [7c Qc]
Diego pb: calls $0.50
dsa8088: folds 
finztothelft: folds 
Marcoj916: calls $0.50
1,1,2,3,5: folds 
Haek82: calls $0.50
1nyyfan: folds 
JMAC60: folds 
deepspace68: calls $0.25
Rockush420: checks 
*** FLOP *** [Jh 8h 3s]
deepspace68: checks 
Rockush420: checks 
Diego pb: checks 
Marcoj916: checks 
Haek82: checks 
*** TURN *** [Jh 8h 3s] [As]
deepspace68: checks 
Rockush420: checks 
Diego pb: checks 
Marcoj916: bets $1
Haek82: calls $1
deepspace68: folds 
Rockush420: raises $1 to $2
Diego pb: calls $2
Marcoj916: calls $1
Haek82: calls $1
*** RIVER *** [Jh 8h 3s As] [9h]
Rockush420: checks 
Diego pb: bets $1
Marcoj916: calls $1
Haek82: raises $1 to $2
Rockush420: folds 
Diego pb: calls $1
Marcoj916: calls $1
*** SHOW DOWN ***
Haek82: shows [Td Qs] (a straight, Eight to Queen)
Diego pb: mucks hand 
Marcoj916: mucks hand 
Haek82 collected $16 from pot
*** SUMMARY ***
Total pot $16.50 | Rake $0.50 
Board [Jh 8h 3s As 9h]
Seat 1: JMAC60 (button) folded before Flop (didn't bet)
Seat 2: deepspace68 (small blind) folded on the Turn
Seat 3: Rockush420 (big blind) folded on the River
Seat 4: Diego pb mucked [3h 3c]
Seat 5: dsa8088 folded before Flop (didn't bet)
Seat 6: finztothelft folded before Flop (didn't bet)
Seat 7: Marcoj916 mucked [Ts Ah]
Seat 8: 1,1,2,3,5 folded before Flop (didn't bet)
Seat 9: Haek82 showed [Td Qs] and won ($16) with a straight, Eight to Queen
Seat 10: 1nyyfan folded before Flop (didn't bet)



PokerStars Game #6807474097:  Hold'em Limit ($0.50/$1.00) - 2006/10/28 - 20:42:15 (ET)
Table 'Tanina' 10-max Seat #2 is the button
Seat 1: JMAC60 ($16.40 in chips) 
Seat 2: deepspace68 ($37.40 in chips) 
Seat 3: Rockush420 ($12 in chips) 
Seat 4: Diego pb ($12.65 in chips) 
Seat 5: dsa8088 ($20.85 in chips) 
Seat 6: finztothelft ($25.15 in chips) 
Seat 7: Marcoj916 ($43.25 in chips) 
Seat 8: 1,1,2,3,5 ($21.75 in chips) 
Seat 9: Haek82 ($38.05 in chips) 
Seat 10: 1nyyfan ($18.35 in chips) 
Rockush420: posts small blind $0.25
Diego pb: posts big blind $0.50
*** HOLE CARDS ***
Dealt to 1,1,2,3,5 [7h 8s]
dsa8088: folds 
finztothelft: raises $0.50 to $1
Marcoj916: folds 
1,1,2,3,5: folds 
Haek82: folds 
1nyyfan: folds 
JMAC60: folds 
deepspace68: folds 
Rockush420: folds 
Diego pb: calls $0.50
*** FLOP *** [9d Jd Ac]
Diego pb: checks 
finztothelft: checks 
*** TURN *** [9d Jd Ac] [Qd]
Diego pb: checks 
finztothelft: bets $1
Diego pb: folds 
finztothelft collected $2.15 from pot
*** SUMMARY ***
Total pot $2.25 | Rake $0.10 
Board [9d Jd Ac Qd]
Seat 1: JMAC60 folded before Flop (didn't bet)
Seat 2: deepspace68 (button) folded before Flop (didn't bet)
Seat 3: Rockush420 (small blind) folded before Flop
Seat 4: Diego pb (big blind) folded on the Turn
Seat 5: dsa8088 folded before Flop (didn't bet)
Seat 6: finztothelft collected ($2.15)
Seat 7: Marcoj916 folded before Flop (didn't bet)
Seat 8: 1,1,2,3,5 folded before Flop (didn't bet)
Seat 9: Haek82 folded before Flop (didn't bet)
Seat 10: 1nyyfan folded before Flop (didn't bet)



PokerStars Game #6807482427:  Hold'em Limit ($0.50/$1.00) - 2006/10/28 - 20:42:55 (ET)
Table 'Tanina' 10-max Seat #3 is the button
Seat 1: JMAC60 ($16.40 in chips) 
Seat 2: deepspace68 ($37.40 in chips) 
Seat 3: Rockush420 ($11.75 in chips) 
Seat 4: Diego pb ($11.65 in chips) 
Seat 5: dsa8088 ($20.85 in chips) 
Seat 6: finztothelft ($26.30 in chips) 
Seat 7: Marcoj916 ($43.25 in chips) 
Seat 8: 1,1,2,3,5 ($21.75 in chips) 
Seat 9: Haek82 ($38.05 in chips) 
Seat 10: 1nyyfan ($18.35 in chips) 
Diego pb: posts small blind $0.25
dsa8088: posts big blind $0.50
*** HOLE CARDS ***
Dealt to 1,1,2,3,5 [4d Ac]
finztothelft: calls $0.50
Marcoj916: folds 
1,1,2,3,5: folds 
Haek82: folds 
1nyyfan: folds 
JMAC60: folds 
deepspace68: calls $0.50
Rockush420: calls $0.50
Diego pb: folds 
dsa8088: checks 
*** FLOP *** [4h 8d Ts]
dsa8088: checks 
finztothelft: checks 
deepspace68: checks 
Rockush420: checks 
*** TURN *** [4h 8d Ts] [Kd]
dsa8088: checks 
finztothelft: checks 
deepspace68: checks 
Rockush420: checks 
*** RIVER *** [4h 8d Ts Kd] [6c]
dsa8088: bets $1
finztothelft: folds 
finztothelft is sitting out
deepspace68: folds 
Rockush420: folds 
finztothelft leaves the table
dsa8088 collected $2.15 from pot
dsa8088: doesn't show hand 
*** SUMMARY ***
Total pot $2.25 | Rake $0.10 
Board [4h 8d Ts Kd 6c]
Seat 1: JMAC60 folded before Flop (didn't bet)
Seat 2: deepspace68 folded on the River
Seat 3: Rockush420 (button) folded on the River
Seat 4: Diego pb (small blind) folded before Flop
Seat 5: dsa8088 (big blind) collected ($2.15)
Seat 6: finztothelft folded on the River
Seat 7: Marcoj916 folded before Flop (didn't bet)
Seat 8: 1,1,2,3,5 folded before Flop (didn't bet)
Seat 9: Haek82 folded before Flop (didn't bet)
Seat 10: 1nyyfan folded before Flop (didn't bet)



PokerStars Game #6807496735:  Hold'em Limit ($0.50/$1.00) - 2006/10/28 - 20:44:06 (ET)
Table 'Tanina' 10-max Seat #4 is the button
Seat 1: JMAC60 ($16.40 in chips) 
Seat 2: deepspace68 ($36.90 in chips) 
Seat 3: Rockush420 ($11.25 in chips) 
Seat 4: Diego pb ($11.40 in chips) 
Seat 5: dsa8088 ($22.50 in chips) 
Seat 7: Marcoj916 ($43.25 in chips) 
Seat 8: 1,1,2,3,5 ($21.75 in chips) 
Seat 9: Haek82 ($38.05 in chips) 
Seat 10: 1nyyfan ($18.35 in chips) 
dsa8088: posts small blind $0.25
Marcoj916: posts big blind $0.50
*** HOLE CARDS ***
Dealt to 1,1,2,3,5 [Qd 3c]
1,1,2,3,5: folds 
TheoParrish joins the table at seat #6 
Haek82: folds 
1nyyfan: calls $0.50
JMAC60: folds 
deepspace68: calls $0.50
Rockush420: folds 
Diego pb: folds 
dsa8088: folds 
Marcoj916: checks 
*** FLOP *** [Th Ks 7s]
Marcoj916: checks 
1nyyfan: checks 
deepspace68: checks 
*** TURN *** [Th Ks 7s] [Jh]
Marcoj916: checks 
1nyyfan: bets $1
deepspace68: folds 
Marcoj916: folds 
1nyyfan collected $1.70 from pot
*** SUMMARY ***
Total pot $1.75 | Rake $0.05 
Board [Th Ks 7s Jh]
Seat 1: JMAC60 folded before Flop (didn't bet)
Seat 2: deepspace68 folded on the Turn
Seat 3: Rockush420 folded before Flop (didn't bet)
Seat 4: Diego pb (button) folded before Flop (didn't bet)
Seat 5: dsa8088 (small blind) folded before Flop
Seat 7: Marcoj916 (big blind) folded on the Turn
Seat 8: 1,1,2,3,5 folded before Flop (didn't bet)
Seat 9: Haek82 folded before Flop (didn't bet)
Seat 10: 1nyyfan collected ($1.70)



PokerStars Game #6807506784:  Hold'em Limit ($0.50/$1.00) - 2006/10/28 - 20:44:55 (ET)
Table 'Tanina' 10-max Seat #5 is the button
Seat 1: JMAC60 ($16.40 in chips) 
Seat 2: deepspace68 ($36.40 in chips) 
Seat 3: Rockush420 ($11.25 in chips) 
Seat 4: Diego pb ($11.40 in chips) 
Seat 5: dsa8088 ($22.25 in chips) 
Seat 7: Marcoj916 ($42.75 in chips) 
Seat 8: 1,1,2,3,5 ($21.75 in chips) 
Seat 9: Haek82 ($38.05 in chips) 
Seat 10: 1nyyfan ($19.55 in chips) 
TheoParrish will be allowed to play after the button
Marcoj916: posts small blind $0.25
1,1,2,3,5: posts big blind $0.50
*** HOLE CARDS ***
Dealt to 1,1,2,3,5 [4d 9c]
Haek82: folds 
1nyyfan: calls $0.50
JMAC60: calls $0.50
deepspace68: calls $0.50
Rockush420: folds 
Diego pb: folds 
dsa8088: folds 
Marcoj916: calls $0.25
1,1,2,3,5: checks 
*** FLOP *** [Kh 3s 2h]
Marcoj916: checks 
1,1,2,3,5: checks 
1nyyfan: bets $0.50
JMAC60: raises $0.50 to $1
deepspace68: folds 
Marcoj916: folds 
1,1,2,3,5: folds 
1nyyfan: calls $0.50
*** TURN *** [Kh 3s 2h] [8c]
1nyyfan: checks 
JMAC60: bets $1
1nyyfan: calls $1
*** RIVER *** [Kh 3s 2h 8c] [Ah]
1nyyfan: checks 
JMAC60: bets $1
1nyyfan: calls $1
*** SHOW DOWN ***
JMAC60: shows [Kd Jd] (a pair of Kings)
1nyyfan: shows [Kc Qh] (a pair of Kings - Ace+Queen kicker)
1nyyfan collected $8.10 from pot
*** SUMMARY ***
Total pot $8.50 | Rake $0.40 
Board [Kh 3s 2h 8c Ah]
Seat 1: JMAC60 showed [Kd Jd] and lost with a pair of Kings
Seat 2: deepspace68 folded on the Flop
Seat 3: Rockush420 folded before Flop (didn't bet)
Seat 4: Diego pb folded before Flop (didn't bet)
Seat 5: dsa8088 (button) folded before Flop (didn't bet)
Seat 7: Marcoj916 (small blind) folded on the Flop
Seat 8: 1,1,2,3,5 (big blind) folded on the Flop
Seat 9: Haek82 folded before Flop (didn't bet)
Seat 10: 1nyyfan showed [Kc Qh] and won ($8.10) with a pair of Kings



PokerStars Game #6807517256:  Hold'em Limit ($0.50/$1.00) - 2006/10/28 - 20:45:47 (ET)
Table 'Tanina' 10-max Seat #7 is the button
Seat 1: JMAC60 ($12.90 in chips) 
Seat 2: deepspace68 ($35.90 in chips) 
Seat 3: Rockush420 ($11.25 in chips) 
Seat 4: Diego pb ($11.40 in chips) 
Seat 5: dsa8088 ($22.25 in chips) 
Seat 6: TheoParrish ($20 in chips) 
Seat 7: Marcoj916 ($42.25 in chips) 
Seat 8: 1,1,2,3,5 ($21.25 in chips) 
Seat 9: Haek82 ($38.05 in chips) 
Seat 10: 1nyyfan ($24.15 in chips) 
1,1,2,3,5: posts small blind $0.25
Haek82: posts big blind $0.50
TheoParrish: posts big blind $0.50
*** HOLE CARDS ***
Dealt to 1,1,2,3,5 [6s Ah]
1nyyfan: folds 
JMAC60: folds 
deepspace68: folds 
Rockush420: calls $0.50
Diego pb: calls $0.50
dsa8088: folds 
TheoParrish: checks 
Marcoj916: folds 
1,1,2,3,5: calls $0.25
Haek82: checks 
*** FLOP *** [2c 7s Kd]
1,1,2,3,5: checks 
Haek82: checks 
Rockush420: bets $0.50
Diego pb: calls $0.50
TheoParrish: folds 
1,1,2,3,5: folds 
Haek82: folds 
*** TURN *** [2c 7s Kd] [2d]
Rockush420: bets $1
Diego pb: calls $1
*** RIVER *** [2c 7s Kd 2d] [Ad]
Rockush420: checks 
Diego pb: bets $1
Rockush420: calls $1
*** SHOW DOWN ***
Diego pb: shows [Kh 6h] (two pair, Kings and Deuces)
Rockush420: mucks hand 
Diego pb collected $7.15 from pot
*** SUMMARY ***
Total pot $7.50 | Rake $0.35 
Board [2c 7s Kd 2d Ad]
Seat 1: JMAC60 folded before Flop (didn't bet)
Seat 2: deepspace68 folded before Flop (didn't bet)
Seat 3: Rockush420 mucked [7c Jh]
Seat 4: Diego pb showed [Kh 6h] and won ($7.15) with two pair, Kings and Deuces
Seat 5: dsa8088 folded before Flop (didn't bet)
Seat 6: TheoParrish folded on the Flop
Seat 7: Marcoj916 (button) folded before Flop (didn't bet)
Seat 8: 1,1,2,3,5 (small blind) folded on the Flop
Seat 9: Haek82 (big blind) folded on the Flop
Seat 10: 1nyyfan folded before Flop (didn't bet)



PokerStars Game #6807529878:  Hold'em Limit ($0.50/$1.00) - 2006/10/28 - 20:46:49 (ET)
Table 'Tanina' 10-max Seat #8 is the button
Seat 1: JMAC60 ($12.90 in chips) 
Seat 2: deepspace68 ($35.90 in chips) 
Seat 3: Rockush420 ($8.25 in chips) 
Seat 4: Diego pb ($15.55 in chips) 
Seat 5: dsa8088 ($22.25 in chips) 
Seat 6: TheoParrish ($19.50 in chips) 
Seat 7: Marcoj916 ($42.25 in chips) 
Seat 8: 1,1,2,3,5 ($20.75 in chips) 
Seat 9: Haek82 ($37.55 in chips) 
Seat 10: 1nyyfan ($24.15 in chips) 
Haek82: posts small blind $0.25
1nyyfan: posts big blind $0.50
*** HOLE CARDS ***
Dealt to 1,1,2,3,5 [4s 9h]
JMAC60: folds 
deepspace68: calls $0.50
Rockush420: folds 
Diego pb: folds 
dsa8088: folds 
TheoParrish: folds 
Marcoj916: folds 
1,1,2,3,5: folds 
Haek82: calls $0.25
Marcoj916 is sitting out
1nyyfan: checks 
*** FLOP *** [Kd 5h Jc]
Marcoj916 leaves the table
Haek82: bets $0.50
1nyyfan: folds 
deepspace68: raises $0.50 to $1
Haek82: folds 
deepspace68 collected $2.40 from pot
*** SUMMARY ***
Total pot $2.50 | Rake $0.10 
Board [Kd 5h Jc]
Seat 1: JMAC60 folded before Flop (didn't bet)
Seat 2: deepspace68 collected ($2.40)
Seat 3: Rockush420 folded before Flop (didn't bet)
Seat 4: Diego pb folded before Flop (didn't bet)
Seat 5: dsa8088 folded before Flop (didn't bet)
Seat 6: TheoParrish folded before Flop (didn't bet)
Seat 7: Marcoj916 folded before Flop (didn't bet)
Seat 8: 1,1,2,3,5 (button) folded before Flop (didn't bet)
Seat 9: Haek82 (small blind) folded on the Flop
Seat 10: 1nyyfan (big blind) folded on the Flop



PokerStars Game #6807537822:  Hold'em Limit ($0.50/$1.00) - 2006/10/28 - 20:47:28 (ET)
Table 'Tanina' 10-max Seat #9 is the button
Seat 1: JMAC60 ($12.90 in chips) 
Seat 2: deepspace68 ($37.30 in chips) 
Seat 3: Rockush420 ($8.25 in chips) 
Seat 4: Diego pb ($15.55 in chips) 
Seat 5: dsa8088 ($22.25 in chips) 
Seat 6: TheoParrish ($19.50 in chips) 
Seat 8: 1,1,2,3,5 ($20.75 in chips) 
Seat 9: Haek82 ($36.55 in chips) 
Seat 10: 1nyyfan ($23.65 in chips) 
1nyyfan: posts small blind $0.25
JMAC60: posts big blind $0.50
*** HOLE CARDS ***
Dealt to 1,1,2,3,5 [3s 6h]
deepspace68: calls $0.50
Rockush420: folds 
Diego pb: folds 
dsa8088: folds 
TheoParrish: folds 
1,1,2,3,5: folds 
Haek82: raises $0.50 to $1
1nyyfan: folds 
JMAC60: calls $0.50
deepspace68: calls $0.50
*** FLOP *** [2d Js 5d]
JMAC60: checks 
lamb1142 joins the table at seat #7 
deepspace68: checks 
Haek82: bets $0.50
JMAC60: raises $0.50 to $1
deepspace68: folds 
Haek82: raises $0.50 to $1.50
JMAC60: raises $0.50 to $2
Betting is capped
Haek82: calls $0.50
*** TURN *** [2d Js 5d] [Ks]
JMAC60: bets $1
Haek82: raises $1 to $2
JMAC60: calls $1
*** RIVER *** [2d Js 5d Ks] [3h]
JMAC60: checks 
Haek82: bets $1
JMAC60: calls $1
*** SHOW DOWN ***
Haek82: shows [Kd Kh] (three of a kind, Kings)
JMAC60: mucks hand 
Haek82 collected $12.75 from pot
*** SUMMARY ***
Total pot $13.25 | Rake $0.50 
Board [2d Js 5d Ks 3h]
Seat 1: JMAC60 (big blind) mucked [Jh Ah]
Seat 2: deepspace68 folded on the Flop
Seat 3: Rockush420 folded before Flop (didn't bet)
Seat 4: Diego pb folded before Flop (didn't bet)
Seat 5: dsa8088 folded before Flop (didn't bet)
Seat 6: TheoParrish folded before Flop (didn't bet)
Seat 8: 1,1,2,3,5 folded before Flop (didn't bet)
Seat 9: Haek82 (button) showed [Kd Kh] and won ($12.75) with three of a kind, Kings
Seat 10: 1nyyfan (small blind) folded before Flop



PokerStars Game #6807547566:  Hold'em Limit ($0.50/$1.00) - 2006/10/28 - 20:48:16 (ET)
Table 'Tanina' 10-max Seat #10 is the button
Seat 1: JMAC60 ($6.90 in chips) 
Seat 2: deepspace68 ($36.30 in chips) 
Seat 3: Rockush420 ($8.25 in chips) 
Seat 4: Diego pb ($15.55 in chips) 
Seat 5: dsa8088 ($22.25 in chips) 
Seat 6: TheoParrish ($19.50 in chips) 
Seat 8: 1,1,2,3,5 ($20.75 in chips) 
Seat 9: Haek82 ($43.30 in chips) 
Seat 10: 1nyyfan ($23.40 in chips) 
JMAC60: posts small blind $0.25
deepspace68: posts big blind $0.50
lamb1142: sits out 
*** HOLE CARDS ***
Dealt to 1,1,2,3,5 [3c Ah]
Rockush420: folds 
Diego pb: calls $0.50
dsa8088: raises $0.50 to $1
TheoParrish: folds 
1,1,2,3,5: folds 
Haek82: folds 
1nyyfan: folds 
JMAC60: folds 
deepspace68: folds 
Diego pb: calls $0.50
*** FLOP *** [As Jh 5h]
Diego pb: checks 
dsa8088: bets $0.50
Diego pb: calls $0.50
*** TURN *** [As Jh 5h] [7d]
Diego pb: checks 
dsa8088: bets $1
Diego pb: calls $1
*** RIVER *** [As Jh 5h 7d] [7c]
Diego pb: checks 
dsa8088: bets $1
Diego pb: folds 
dsa8088 collected $5.50 from pot
dsa8088: doesn't show hand 
*** SUMMARY ***
Total pot $5.75 | Rake $0.25 
Board [As Jh 5h 7d 7c]
Seat 1: JMAC60 (small blind) folded before Flop
Seat 2: deepspace68 (big blind) folded before Flop
Seat 3: Rockush420 folded before Flop (didn't bet)
Seat 4: Diego pb folded on the River
Seat 5: dsa8088 collected ($5.50)
Seat 6: TheoParrish folded before Flop (didn't bet)
Seat 8: 1,1,2,3,5 folded before Flop (didn't bet)
Seat 9: Haek82 folded before Flop (didn't bet)
Seat 10: 1nyyfan (button) folded before Flop (didn't bet)



PokerStars Game #6807556382:  Hold'em Limit ($0.50/$1.00) - 2006/10/28 - 20:48:59 (ET)
Table 'Tanina' 10-max Seat #1 is the button
Seat 1: JMAC60 ($16.65 in chips) 
Seat 2: deepspace68 ($35.80 in chips) 
Seat 3: Rockush420 ($8.25 in chips) 
Seat 4: Diego pb ($13.05 in chips) 
Seat 5: dsa8088 ($25.25 in chips) 
Seat 6: TheoParrish ($19.50 in chips) 
Seat 8: 1,1,2,3,5 ($20.75 in chips) 
Seat 9: Haek82 ($43.30 in chips) 
Seat 10: 1nyyfan ($23.40 in chips) 
deepspace68: posts small blind $0.25
Rockush420: posts big blind $0.50
lamb1142: sits out 
*** HOLE CARDS ***
Dealt to 1,1,2,3,5 [2d Js]
Diego pb: folds 
dsa8088: folds 
TheoParrish: folds 
1,1,2,3,5: folds 
Haek82: folds 
1nyyfan: calls $0.50
JMAC60: folds 
deepspace68: calls $0.25
Rockush420: checks 
*** FLOP *** [8h 4c Jc]
deepspace68: checks 
Rockush420: checks 
1nyyfan: bets $0.50
deepspace68: calls $0.50
Rockush420: folds 
*** TURN *** [8h 4c Jc] [Kh]
deepspace68: checks 
1nyyfan: bets $1
deepspace68: calls $1
*** RIVER *** [8h 4c Jc Kh] [9c]
deepspace68: checks 
1nyyfan: checks 
*** SHOW DOWN ***
deepspace68: shows [9h Ah] (a pair of Nines)
1nyyfan: shows [As Jd] (a pair of Jacks)
1nyyfan collected $4.30 from pot
*** SUMMARY ***
Total pot $4.50 | Rake $0.20 
Board [8h 4c Jc Kh 9c]
Seat 1: JMAC60 (button) folded before Flop (didn't bet)
Seat 2: deepspace68 (small blind) showed [9h Ah] and lost with a pair of Nines
Seat 3: Rockush420 (big blind) folded on the Flop
Seat 4: Diego pb folded before Flop (didn't bet)
Seat 5: dsa8088 folded before Flop (didn't bet)
Seat 6: TheoParrish folded before Flop (didn't bet)
Seat 8: 1,1,2,3,5 folded before Flop (didn't bet)
Seat 9: Haek82 folded before Flop (didn't bet)
Seat 10: 1nyyfan showed [As Jd] and won ($4.30) with a pair of Jacks



PokerStars Game #6807564722:  Hold'em Limit ($0.50/$1.00) - 2006/10/28 - 20:49:40 (ET)
Table 'Tanina' 10-max Seat #2 is the button
Seat 1: JMAC60 ($16.65 in chips) 
Seat 2: deepspace68 ($33.80 in chips) 
Seat 3: Rockush420 ($7.75 in chips) 
Seat 4: Diego pb ($13.05 in chips) 
Seat 5: dsa8088 ($25.25 in chips) 
Seat 6: TheoParrish ($19.50 in chips) 
Seat 8: 1,1,2,3,5 ($20.75 in chips) 
Seat 9: Haek82 ($43.30 in chips) 
Seat 10: 1nyyfan ($25.70 in chips) 
Rockush420: posts small blind $0.25
Diego pb: posts big blind $0.50
lamb1142: sits out 
*** HOLE CARDS ***
Dealt to 1,1,2,3,5 [Ks 6h]
dsa8088: folds 
TheoParrish: calls $0.50
1,1,2,3,5: folds 
Haek82: folds 
1nyyfan: calls $0.50
JMAC60: folds 
deepspace68: folds 
Rockush420: calls $0.25
Diego pb: checks 
*** FLOP *** [Ac Kd 9c]
Rockush420: bets $0.50
Diego pb: calls $0.50
TheoParrish: calls $0.50
1nyyfan: folds 
*** TURN *** [Ac Kd 9c] [Jh]
Rockush420: checks 
Diego pb: checks 
TheoParrish: bets $1
Rockush420: folds 
Diego pb: raises $1 to $2
TheoParrish: calls $1
*** RIVER *** [Ac Kd 9c Jh] [4h]
Diego pb: bets $1
TheoParrish: calls $1
*** SHOW DOWN ***
Diego pb: shows [Jd As] (two pair, Aces and Jacks)
TheoParrish: mucks hand 
Diego pb collected $9.05 from pot
*** SUMMARY ***
Total pot $9.50 | Rake $0.45 
Board [Ac Kd 9c Jh 4h]
Seat 1: JMAC60 folded before Flop (didn't bet)
Seat 2: deepspace68 (button) folded before Flop (didn't bet)
Seat 3: Rockush420 (small blind) folded on the Turn
Seat 4: Diego pb (big blind) showed [Jd As] and won ($9.05) with two pair, Aces and Jacks
Seat 5: dsa8088 folded before Flop (didn't bet)
Seat 6: TheoParrish mucked [Ah Ts]
Seat 8: 1,1,2,3,5 folded before Flop (didn't bet)
Seat 9: Haek82 folded before Flop (didn't bet)
Seat 10: 1nyyfan folded on the Flop



PokerStars Game #6807574833:  Hold'em Limit ($0.50/$1.00) - 2006/10/28 - 20:50:29 (ET)
Table 'Tanina' 10-max Seat #3 is the button
Seat 1: JMAC60 ($16.65 in chips) 
Seat 2: deepspace68 ($33.80 in chips) 
Seat 3: Rockush420 ($6.75 in chips) 
Seat 4: Diego pb ($18.10 in chips) 
Seat 5: dsa8088 ($25.25 in chips) 
Seat 6: TheoParrish ($15.50 in chips) 
Seat 8: 1,1,2,3,5 ($20.75 in chips) 
Seat 9: Haek82 ($43.30 in chips) 
Seat 10: 1nyyfan ($25.20 in chips) 
Diego pb: posts small blind $0.25
dsa8088: posts big blind $0.50
lamb1142: sits out 
*** HOLE CARDS ***
Dealt to 1,1,2,3,5 [Qh 2s]
TheoParrish: folds 
1,1,2,3,5: folds 
Haek82: folds 
1nyyfan: folds 
JMAC60: folds 
deepspace68: calls $0.50
Rockush420: folds 
Diego pb: calls $0.25
dsa8088: checks 
*** FLOP *** [6h 4c 8s]
Diego pb: checks 
dsa8088: checks 
deepspace68: checks 
*** TURN *** [6h 4c 8s] [9d]
Diego pb: bets $1
dsa8088: folds 
deepspace68: calls $1
*** RIVER *** [6h 4c 8s 9d] [7h]
Diego pb: bets $1
deepspace68: folds 
Diego pb collected $3.35 from pot
*** SUMMARY ***
Total pot $3.50 | Rake $0.15 
Board [6h 4c 8s 9d 7h]
Seat 1: JMAC60 folded before Flop (didn't bet)
Seat 2: deepspace68 folded on the River
Seat 3: Rockush420 (button) folded before Flop (didn't bet)
Seat 4: Diego pb (small blind) collected ($3.35)
Seat 5: dsa8088 (big blind) folded on the Turn
Seat 6: TheoParrish folded before Flop (didn't bet)
Seat 8: 1,1,2,3,5 folded before Flop (didn't bet)
Seat 9: Haek82 folded before Flop (didn't bet)
Seat 10: 1nyyfan folded before Flop (didn't bet)



PokerStars Game #6807584691:  Hold'em Limit ($0.50/$1.00) - 2006/10/28 - 20:51:17 (ET)
Table 'Tanina' 10-max Seat #4 is the button
Seat 1: JMAC60 ($16.65 in chips) 
Seat 2: deepspace68 ($32.30 in chips) 
Seat 3: Rockush420 ($6.75 in chips) 
Seat 4: Diego pb ($19.95 in chips) 
Seat 5: dsa8088 ($24.75 in chips) 
Seat 6: TheoParrish ($15.50 in chips) 
Seat 8: 1,1,2,3,5 ($20.75 in chips) 
Seat 9: Haek82 ($43.30 in chips) 
Seat 10: 1nyyfan ($25.20 in chips) 
dsa8088: posts small blind $0.25
TheoParrish: posts big blind $0.50
lamb1142: sits out 
*** HOLE CARDS ***
Dealt to 1,1,2,3,5 [4c 5h]
1,1,2,3,5: folds 
Haek82: calls $0.50
1nyyfan: folds 
JMAC60: raises $0.50 to $1
deepspace68: folds 
Rockush420: folds 
Diego pb: folds 
dsa8088: calls $0.75
TheoParrish: calls $0.50
Haek82: calls $0.50
*** FLOP *** [7h 5d 9c]
dsa8088: checks 
TheoParrish: checks 
Haek82: checks 
JMAC60: bets $0.50
dsa8088: folds 
TheoParrish: calls $0.50
Haek82: calls $0.50
*** TURN *** [7h 5d 9c] [Td]
TheoParrish: checks 
Haek82: checks 
JMAC60: bets $1
TheoParrish: calls $1
Haek82: folds 
*** RIVER *** [7h 5d 9c Td] [4h]
TheoParrish: checks 
JMAC60: bets $1
TheoParrish: folds 
JMAC60 collected $7.15 from pot
JMAC60: doesn't show hand 
*** SUMMARY ***
Total pot $7.50 | Rake $0.35 
Board [7h 5d 9c Td 4h]
Seat 1: JMAC60 collected ($7.15)
Seat 2: deepspace68 folded before Flop (didn't bet)
Seat 3: Rockush420 folded before Flop (didn't bet)
Seat 4: Diego pb (button) folded before Flop (didn't bet)
Seat 5: dsa8088 (small blind) folded on the Flop
Seat 6: TheoParrish (big blind) folded on the River
Seat 8: 1,1,2,3,5 folded before Flop (didn't bet)
Seat 9: Haek82 folded on the Turn
Seat 10: 1nyyfan folded before Flop (didn't bet)



PokerStars Game #6807597305:  Hold'em Limit ($0.50/$1.00) - 2006/10/28 - 20:52:19 (ET)
Table 'Tanina' 10-max Seat #5 is the button
Seat 1: JMAC60 ($21.30 in chips) 
Seat 2: deepspace68 ($32.30 in chips) 
Seat 3: Rockush420 ($6.75 in chips) 
Seat 4: Diego pb ($19.95 in chips) 
Seat 5: dsa8088 ($23.75 in chips) 
Seat 6: TheoParrish ($13 in chips) 
Seat 7: lamb1142 ($17.25 in chips) 
Seat 8: 1,1,2,3,5 ($20.75 in chips) 
Seat 9: Haek82 ($41.80 in chips) 
Seat 10: 1nyyfan ($25.20 in chips) 
TheoParrish: posts small blind $0.25
lamb1142: posts big blind $0.50
*** HOLE CARDS ***
Dealt to 1,1,2,3,5 [3c Kh]
1,1,2,3,5: folds 
Haek82: folds 
1nyyfan: calls $0.50
JMAC60: folds 
deepspace68: folds 
Rockush420: folds 
Diego pb: folds 
dsa8088: folds 
TheoParrish: calls $0.25
lamb1142: checks 
*** FLOP *** [Jc 5c 9d]
TheoParrish: checks 
lamb1142: checks 
1nyyfan: checks 
*** TURN *** [Jc 5c 9d] [6s]
TheoParrish: checks 
lamb1142: bets $1
1nyyfan: calls $1
TheoParrish: folds 
*** RIVER *** [Jc 5c 9d 6s] [Qs]
lamb1142: checks 
1nyyfan: checks 
*** SHOW DOWN ***
lamb1142: shows [4s 7s] (high card Queen)
1nyyfan: shows [8s 8c] (a pair of Eights)
1nyyfan collected $3.35 from pot
*** SUMMARY ***
Total pot $3.50 | Rake $0.15 
Board [Jc 5c 9d 6s Qs]
Seat 1: JMAC60 folded before Flop (didn't bet)
Seat 2: deepspace68 folded before Flop (didn't bet)
Seat 3: Rockush420 folded before Flop (didn't bet)
Seat 4: Diego pb folded before Flop (didn't bet)
Seat 5: dsa8088 (button) folded before Flop (didn't bet)
Seat 6: TheoParrish (small blind) folded on the Turn
Seat 7: lamb1142 (big blind) showed [4s 7s] and lost with high card Queen
Seat 8: 1,1,2,3,5 folded before Flop (didn't bet)
Seat 9: Haek82 folded before Flop (didn't bet)
Seat 10: 1nyyfan showed [8s 8c] and won ($3.35) with a pair of Eights



PokerStars Game #6807607398:  Hold'em Limit ($0.50/$1.00) - 2006/10/28 - 20:53:08 (ET)
Table 'Tanina' 10-max Seat #6 is the button
Seat 1: JMAC60 ($21.30 in chips) 
Seat 2: deepspace68 ($32.30 in chips) 
Seat 3: Rockush420 ($6.75 in chips) 
Seat 4: Diego pb ($19.95 in chips) 
Seat 5: dsa8088 ($23.75 in chips) 
Seat 6: TheoParrish ($12.50 in chips) 
Seat 7: lamb1142 ($15.75 in chips) 
Seat 8: 1,1,2,3,5 ($20.75 in chips) 
Seat 9: Haek82 ($41.80 in chips) 
Seat 10: 1nyyfan ($27.05 in chips) 
lamb1142: posts small blind $0.25
1,1,2,3,5: posts big blind $0.50
*** HOLE CARDS ***
Dealt to 1,1,2,3,5 [2d 7s]
Haek82: folds 
1nyyfan: folds 
JMAC60: folds 
deepspace68: calls $0.50
Rockush420: folds 
Diego pb: folds 
dsa8088: calls $0.50
TheoParrish: raises $0.50 to $1
lamb1142: folds 
1,1,2,3,5: folds 
deepspace68: folds 
dsa8088: calls $0.50
*** FLOP *** [8c Js Ad]
dsa8088: checks 
TheoParrish: bets $0.50
dsa8088: calls $0.50
*** TURN *** [8c Js Ad] [Ts]
dsa8088: checks 
TheoParrish: bets $1
dsa8088: folds 
TheoParrish collected $4.05 from pot
TheoParrish: doesn't show hand 
*** SUMMARY ***
Total pot $4.25 | Rake $0.20 
Board [8c Js Ad Ts]
Seat 1: JMAC60 folded before Flop (didn't bet)
Seat 2: deepspace68 folded before Flop
Seat 3: Rockush420 folded before Flop (didn't bet)
Seat 4: Diego pb folded before Flop (didn't bet)
Seat 5: dsa8088 folded on the Turn
Seat 6: TheoParrish (button) collected ($4.05)
Seat 7: lamb1142 (small blind) folded before Flop
Seat 8: 1,1,2,3,5 (big blind) folded before Flop
Seat 9: Haek82 folded before Flop (didn't bet)
Seat 10: 1nyyfan folded before Flop (didn't bet)



PokerStars Game #6807616160:  Hold'em Limit ($0.50/$1.00) - 2006/10/28 - 20:53:51 (ET)
Table 'Tanina' 10-max Seat #7 is the button
Seat 1: JMAC60 ($21.30 in chips) 
Seat 2: deepspace68 ($31.80 in chips) 
Seat 3: Rockush420 ($6.75 in chips) 
Seat 4: Diego pb ($19.95 in chips) 
Seat 5: dsa8088 ($22.25 in chips) 
Seat 6: TheoParrish ($15.05 in chips) 
Seat 7: lamb1142 ($15.50 in chips) 
Seat 8: 1,1,2,3,5 ($20.25 in chips) 
Seat 9: Haek82 ($41.80 in chips) 
Seat 10: 1nyyfan ($27.05 in chips) 
1,1,2,3,5: posts small blind $0.25
Haek82: posts big blind $0.50
*** HOLE CARDS ***
Dealt to 1,1,2,3,5 [3s As]
1nyyfan: folds 
JMAC60: folds 
deepspace68: folds 
Rockush420: calls $0.50
Diego pb: raises $0.50 to $1
dsa8088: folds 
TheoParrish: folds 
lamb1142: folds 
1,1,2,3,5: folds 
Haek82: folds 
Rockush420: calls $0.50
*** FLOP *** [5h 3c 5s]
Rockush420: checks 
Diego pb: bets $0.50
Rockush420: calls $0.50
*** TURN *** [5h 3c 5s] [9s]
Rockush420: checks 
Diego pb: bets $1
Rockush420: calls $1
*** RIVER *** [5h 3c 5s 9s] [8c]
Rockush420: checks 
Diego pb: bets $1
Rockush420: calls $1
*** SHOW DOWN ***
Diego pb: shows [Ac Qd] (a pair of Fives)
Rockush420: shows [Qs 9d] (two pair, Nines and Fives)
Rockush420 collected $7.40 from pot
*** SUMMARY ***
Total pot $7.75 | Rake $0.35 
Board [5h 3c 5s 9s 8c]
Seat 1: JMAC60 folded before Flop (didn't bet)
Seat 2: deepspace68 folded before Flop (didn't bet)
Seat 3: Rockush420 showed [Qs 9d] and won ($7.40) with two pair, Nines and Fives
Seat 4: Diego pb showed [Ac Qd] and lost with a pair of Fives
Seat 5: dsa8088 folded before Flop (didn't bet)
Seat 6: TheoParrish folded before Flop (didn't bet)
Seat 7: lamb1142 (button) folded before Flop (didn't bet)
Seat 8: 1,1,2,3,5 (small blind) folded before Flop
Seat 9: Haek82 (big blind) folded before Flop
Seat 10: 1nyyfan folded before Flop (didn't bet)



PokerStars Game #6807627484:  Hold'em Limit ($0.50/$1.00) - 2006/10/28 - 20:54:47 (ET)
Table 'Tanina' 10-max Seat #8 is the button
Seat 1: JMAC60 ($21.30 in chips) 
Seat 2: deepspace68 ($31.80 in chips) 
Seat 3: Rockush420 ($10.65 in chips) 
Seat 4: Diego pb ($16.45 in chips) 
Seat 5: dsa8088 ($22.25 in chips) 
Seat 6: TheoParrish ($15.05 in chips) 
Seat 7: lamb1142 ($15.50 in chips) 
Seat 8: 1,1,2,3,5 ($20 in chips) 
Seat 9: Haek82 ($41.30 in chips) 
Seat 10: 1nyyfan ($27.05 in chips) 
Haek82: posts small blind $0.25
1nyyfan: posts big blind $0.50
*** HOLE CARDS ***
Dealt to 1,1,2,3,5 [2d 9h]
JMAC60: folds 
deepspace68: folds 
Rockush420: folds 
Diego pb: folds 
dsa8088: calls $0.50
TheoParrish: folds 
lamb1142: folds 
1,1,2,3,5: folds 
Haek82: raises $0.50 to $1
1nyyfan: calls $0.50
dsa8088: calls $0.50
*** FLOP *** [Ts Kc 2h]
Haek82: bets $0.50
1nyyfan: raises $0.50 to $1
dsa8088: folds 
Haek82: calls $0.50
*** TURN *** [Ts Kc 2h] [Js]
Haek82: checks 
1nyyfan: bets $1
Haek82: calls $1
*** RIVER *** [Ts Kc 2h Js] [9c]
Haek82: bets $1
1nyyfan: calls $1
*** SHOW DOWN ***
Haek82: shows [Ks Qh] (a straight, Nine to King)
1nyyfan: shows [Tc Kd] (two pair, Kings and Tens)
Haek82 collected $8.60 from pot
*** SUMMARY ***
Total pot $9 | Rake $0.40 
Board [Ts Kc 2h Js 9c]
Seat 1: JMAC60 folded before Flop (didn't bet)
Seat 2: deepspace68 folded before Flop (didn't bet)
Seat 3: Rockush420 folded before Flop (didn't bet)
Seat 4: Diego pb folded before Flop (didn't bet)
Seat 5: dsa8088 folded on the Flop
Seat 6: TheoParrish folded before Flop (didn't bet)
Seat 7: lamb1142 folded before Flop (didn't bet)
Seat 8: 1,1,2,3,5 (button) folded before Flop (didn't bet)
Seat 9: Haek82 (small blind) showed [Ks Qh] and won ($8.60) with a straight, Nine to King
Seat 10: 1nyyfan (big blind) showed [Tc Kd] and lost with two pair, Kings and Tens



PokerStars Game #6807637848:  Hold'em Limit ($0.50/$1.00) - 2006/10/28 - 20:55:37 (ET)
Table 'Tanina' 10-max Seat #9 is the button
Seat 1: JMAC60 ($21.30 in chips) 
Seat 2: deepspace68 ($31.80 in chips) 
Seat 3: Rockush420 ($10.65 in chips) 
Seat 4: Diego pb ($16.45 in chips) 
Seat 5: dsa8088 ($21.25 in chips) 
Seat 6: TheoParrish ($15.05 in chips) 
Seat 7: lamb1142 ($15.50 in chips) 
Seat 8: 1,1,2,3,5 ($20 in chips) 
Seat 9: Haek82 ($45.90 in chips) 
Seat 10: 1nyyfan ($23.05 in chips) 
1nyyfan: posts small blind $0.25
JMAC60: posts big blind $0.50
*** HOLE CARDS ***
Dealt to 1,1,2,3,5 [As 4s]
deepspace68: folds 
Rockush420: folds 
Diego pb: calls $0.50
dsa8088: folds 
TheoParrish: folds 
lamb1142: folds 
1,1,2,3,5: folds 
Haek82: folds 
1nyyfan: calls $0.25
JMAC60: checks 
*** FLOP *** [Qs Jd 5d]
1nyyfan: bets $0.50
JMAC60: calls $0.50
Diego pb: calls $0.50
*** TURN *** [Qs Jd 5d] [Th]
1nyyfan: bets $1
JMAC60: raises $1 to $2
Diego pb: calls $2
1nyyfan: calls $1
*** RIVER *** [Qs Jd 5d Th] [3d]
1nyyfan: checks 
JMAC60: bets $1
Diego pb: calls $1
1nyyfan: calls $1
*** SHOW DOWN ***
JMAC60: shows [9d Kc] (a straight, Nine to King)
Diego pb: mucks hand 
1nyyfan: mucks hand 
JMAC60 collected $11.50 from pot
*** SUMMARY ***
Total pot $12 | Rake $0.50 
Board [Qs Jd 5d Th 3d]
Seat 1: JMAC60 (big blind) showed [9d Kc] and won ($11.50) with a straight, Nine to King
Seat 2: deepspace68 folded before Flop (didn't bet)
Seat 3: Rockush420 folded before Flop (didn't bet)
Seat 4: Diego pb mucked [5c 5h]
Seat 5: dsa8088 folded before Flop (didn't bet)
Seat 6: TheoParrish folded before Flop (didn't bet)
Seat 7: lamb1142 folded before Flop (didn't bet)
Seat 8: 1,1,2,3,5 folded before Flop (didn't bet)
Seat 9: Haek82 (button) folded before Flop (didn't bet)
Seat 10: 1nyyfan (small blind) mucked [Qc Jh]



PokerStars Game #6807646761:  Hold'em Limit ($0.50/$1.00) - 2006/10/28 - 20:56:21 (ET)
Table 'Tanina' 10-max Seat #10 is the button
Seat 1: JMAC60 ($28.80 in chips) 
Seat 2: deepspace68 ($31.80 in chips) 
Seat 3: Rockush420 ($10.65 in chips) 
Seat 4: Diego pb ($12.45 in chips) 
Seat 5: dsa8088 ($21.25 in chips) 
Seat 6: TheoParrish ($15.05 in chips) 
Seat 7: lamb1142 ($15.50 in chips) 
Seat 8: 1,1,2,3,5 ($20 in chips) 
Seat 9: Haek82 ($45.90 in chips) 
Seat 10: 1nyyfan ($19.05 in chips) 
JMAC60: posts small blind $0.25
Diego pb said, "\0"
deepspace68: posts big blind $0.50
*** HOLE CARDS ***
Dealt to 1,1,2,3,5 [4s Qd]
Rockush420: calls $0.50
Diego pb: calls $0.50
dsa8088: raises $0.50 to $1
TheoParrish: folds 
lamb1142: folds 
1,1,2,3,5: folds 
Haek82: folds 
1nyyfan: folds 
JMAC60: folds 
deepspace68: calls $0.50
Rockush420: calls $0.50
Diego pb: calls $0.50
*** FLOP *** [7d 6d 9h]
deepspace68: checks 
Rockush420: checks 
Diego pb: bets $0.50
dsa8088: raises $0.50 to $1
deepspace68: calls $1
Rockush420: calls $1
Diego pb: calls $0.50
*** TURN *** [7d 6d 9h] [Ts]
deepspace68: checks 
Rockush420: checks 
Diego pb: bets $1
dsa8088: calls $1
deepspace68: raises $1 to $2
Rockush420: calls $2
Diego pb: calls $1
dsa8088: folds 
*** RIVER *** [7d 6d 9h Ts] [6h]
deepspace68: bets $1
Rockush420: raises $1 to $2
Diego pb: calls $2
deepspace68: raises $1 to $3
Rockush420: raises $1 to $4
Betting is capped
Diego pb: calls $2
deepspace68: calls $1
*** SHOW DOWN ***
Rockush420: shows [7c 7h] (a full house, Sevens full of Sixes)
Diego pb: mucks hand 
deepspace68: mucks hand 
Rockush420 collected $26.75 from pot
*** SUMMARY ***
Total pot $27.25 | Rake $0.50 
Board [7d 6d 9h Ts 6h]
Seat 1: JMAC60 (small blind) folded before Flop
Seat 2: deepspace68 (big blind) mucked [Ac 8h]
Seat 3: Rockush420 showed [7c 7h] and won ($26.75) with a full house, Sevens full of Sixes
Seat 4: Diego pb mucked [Ad 8c]
Seat 5: dsa8088 folded on the Turn
Seat 6: TheoParrish folded before Flop (didn't bet)
Seat 7: lamb1142 folded before Flop (didn't bet)
Seat 8: 1,1,2,3,5 folded before Flop (didn't bet)
Seat 9: Haek82 folded before Flop (didn't bet)
Seat 10: 1nyyfan (button) folded before Flop (didn't bet)



PokerStars Game #6807665498:  Hold'em Limit ($0.50/$1.00) - 2006/10/28 - 20:57:52 (ET)
Table 'Tanina' 10-max Seat #1 is the button
Seat 1: JMAC60 ($28.55 in chips) 
Seat 2: deepspace68 ($23.80 in chips) 
Seat 3: Rockush420 ($29.40 in chips) 
Seat 4: Diego pb ($4.45 in chips) 
Seat 5: dsa8088 ($18.25 in chips) 
Seat 6: TheoParrish ($15.05 in chips) 
Seat 7: lamb1142 ($15.50 in chips) 
Seat 8: 1,1,2,3,5 ($20 in chips) 
Seat 9: Haek82 ($45.90 in chips) 
Seat 10: 1nyyfan ($19.05 in chips) 
deepspace68: posts small blind $0.25
Rockush420: posts big blind $0.50
*** HOLE CARDS ***
Dealt to 1,1,2,3,5 [4c Ad]
Diego pb said, "nice ****ing chase"
Diego pb said, "unreal"
Diego pb: calls $0.50
dsa8088: folds 
TheoParrish: folds 
lamb1142: folds 
Rockush420 said, "easy"
1,1,2,3,5: folds 
Haek82: folds 
1nyyfan: folds 
JMAC60: folds 
deepspace68 said, "nh"
deepspace68: folds 
Rockush420 said, " ty"
Diego pb said, "easyhahahah your brutakl"
Rockush420: checks 
*** FLOP *** [2d Kd Qs]
Rockush420: checks 
Diego pb: checks 
*** TURN *** [2d Kd Qs] [7d]
Rockush420: checks 
Diego pb: checks 
*** RIVER *** [2d Kd Qs 7d] [6c]
Rockush420: checks 
Diego pb: checks 
*** SHOW DOWN ***
Rockush420: shows [7h 2s] (two pair, Sevens and Deuces)
Diego pb: mucks hand 
Rockush420 collected $1.20 from pot
*** SUMMARY ***
Total pot $1.25 | Rake $0.05 
Board [2d Kd Qs 7d 6c]
Seat 1: JMAC60 (button) folded before Flop (didn't bet)
Seat 2: deepspace68 (small blind) folded before Flop
Seat 3: Rockush420 (big blind) showed [7h 2s] and won ($1.20) with two pair, Sevens and Deuces
Seat 4: Diego pb mucked [Th 9c]
Seat 5: dsa8088 folded before Flop (didn't bet)
Seat 6: TheoParrish folded before Flop (didn't bet)
Seat 7: lamb1142 folded before Flop (didn't bet)
Seat 8: 1,1,2,3,5 folded before Flop (didn't bet)
Seat 9: Haek82 folded before Flop (didn't bet)
Seat 10: 1nyyfan folded before Flop (didn't bet)



PokerStars Game #6807672118:  Hold'em Limit ($0.50/$1.00) - 2006/10/28 - 20:58:25 (ET)
Table 'Tanina' 10-max Seat #2 is the button
Seat 1: JMAC60 ($28.55 in chips) 
Seat 2: deepspace68 ($23.55 in chips) 
Seat 3: Rockush420 ($30.10 in chips) 
Seat 4: Diego pb ($3.95 in chips) 
Seat 5: dsa8088 ($18.25 in chips) 
Seat 6: TheoParrish ($15.05 in chips) 
Seat 7: lamb1142 ($15.50 in chips) 
Seat 8: 1,1,2,3,5 ($20 in chips) 
Seat 9: Haek82 ($45.90 in chips) 
Seat 10: 1nyyfan ($19.05 in chips) 
Rockush420: posts small blind $0.25
Diego pb: posts big blind $0.50
*** HOLE CARDS ***
Dealt to 1,1,2,3,5 [Ad 5c]
dsa8088: folds 
TheoParrish: folds 
lamb1142: folds 
1,1,2,3,5: folds 
Haek82: calls $0.50
1nyyfan: folds 
JMAC60: folds 
deepspace68: calls $0.50
Rockush420: calls $0.25
Diego pb: checks 
*** FLOP *** [9h 5d Ah]
Rockush420: checks 
Diego pb: checks 
Haek82: checks 
deepspace68: bets $0.50
Rockush420: folds 
Diego pb: folds 
Haek82: folds 
deepspace68 said, "not so easy without the river rock ;-)"
deepspace68 collected $1.90 from pot
*** SUMMARY ***
Total pot $2 | Rake $0.10 
Board [9h 5d Ah]
Seat 1: JMAC60 folded before Flop (didn't bet)
Seat 2: deepspace68 (button) collected ($1.90)
Seat 3: Rockush420 (small blind) folded on the Flop
Seat 4: Diego pb (big blind) folded on the Flop
Seat 5: dsa8088 folded before Flop (didn't bet)
Seat 6: TheoParrish folded before Flop (didn't bet)
Seat 7: lamb1142 folded before Flop (didn't bet)
Seat 8: 1,1,2,3,5 folded before Flop (didn't bet)
Seat 9: Haek82 folded on the Flop
Seat 10: 1nyyfan folded before Flop (didn't bet)



PokerStars Game #6807680943:  Hold'em Limit ($0.50/$1.00) - 2006/10/28 - 20:59:09 (ET)
Table 'Tanina' 10-max Seat #3 is the button
Seat 1: JMAC60 ($28.55 in chips) 
Seat 2: deepspace68 ($24.95 in chips) 
Seat 3: Rockush420 ($29.60 in chips) 
Seat 4: Diego pb ($3.45 in chips) 
Seat 5: dsa8088 ($18.25 in chips) 
Seat 6: TheoParrish ($15.05 in chips) 
Seat 7: lamb1142 ($15.50 in chips) 
Seat 8: 1,1,2,3,5 ($20 in chips) 
Seat 9: Haek82 ($45.40 in chips) 
Seat 10: 1nyyfan ($19.05 in chips) 
Diego pb: posts small blind $0.25
dsa8088: posts big blind $0.50
*** HOLE CARDS ***
Dealt to 1,1,2,3,5 [9h 7d]
TheoParrish: folds 
lamb1142: folds 
Rockush420 said, "heh"
1,1,2,3,5: folds 
Haek82: folds 
1nyyfan: folds 
JMAC60: folds 
deepspace68: folds 
Rockush420: raises $0.50 to $1
Diego pb: folds 
dsa8088: folds 
Rockush420 collected $1.25 from pot
*** SUMMARY ***
Total pot $1.25 | Rake $0 
Seat 1: JMAC60 folded before Flop (didn't bet)
Seat 2: deepspace68 folded before Flop (didn't bet)
Seat 3: Rockush420 (button) collected ($1.25)
Seat 4: Diego pb (small blind) folded before Flop
Seat 5: dsa8088 (big blind) folded before Flop
Seat 6: TheoParrish folded before Flop (didn't bet)
Seat 7: lamb1142 folded before Flop (didn't bet)
Seat 8: 1,1,2,3,5 folded before Flop (didn't bet)
Seat 9: Haek82 folded before Flop (didn't bet)
Seat 10: 1nyyfan folded before Flop (didn't bet)



PokerStars Game #6807685748:  Hold'em Limit ($0.50/$1.00) - 2006/10/28 - 20:59:31 (ET)
Table 'Tanina' 10-max Seat #4 is the button
Seat 1: JMAC60 ($28.55 in chips) 
Seat 2: deepspace68 ($24.95 in chips) 
Seat 3: Rockush420 ($30.35 in chips) 
Seat 4: Diego pb ($3.20 in chips) 
Seat 5: dsa8088 ($17.75 in chips) 
Seat 6: TheoParrish ($15.05 in chips) 
Seat 7: lamb1142 ($15.50 in chips) 
Seat 8: 1,1,2,3,5 ($20 in chips) 
Seat 9: Haek82 ($45.40 in chips) 
Seat 10: 1nyyfan ($19.05 in chips) 
dsa8088: posts small blind $0.25
TheoParrish: posts big blind $0.50
*** HOLE CARDS ***
Dealt to 1,1,2,3,5 [2s 2h]
Rockush420 said, " sorry didnt feel like folding :)"
lamb1142: folds 
1,1,2,3,5: calls $0.50
Haek82: folds 
1nyyfan: folds 
JMAC60: folds 
deepspace68: folds 
Rockush420: folds 
Diego pb: calls $0.50
dsa8088: folds 
TheoParrish: checks 
*** FLOP *** [4c 4d Tc]
TheoParrish: checks 
1,1,2,3,5: checks 
Diego pb: bets $0.50
TheoParrish: folds 
1,1,2,3,5: calls $0.50
*** TURN *** [4c 4d Tc] [9s]
Diego pb said, "thats cause your an ***"
deepspace68 said, "sure not....you had nice pot odds ;-)"
1,1,2,3,5: checks 
Diego pb: bets $1
1,1,2,3,5: folds 
Diego pb collected $2.65 from pot
Diego pb: doesn't show hand 
*** SUMMARY ***
Total pot $2.75 | Rake $0.10 
Board [4c 4d Tc 9s]
Seat 1: JMAC60 folded before Flop (didn't bet)
Seat 2: deepspace68 folded before Flop (didn't bet)
Seat 3: Rockush420 folded before Flop (didn't bet)
Seat 4: Diego pb (button) collected ($2.65)
Seat 5: dsa8088 (small blind) folded before Flop
Seat 6: TheoParrish (big blind) folded on the Flop
Seat 7: lamb1142 folded before Flop (didn't bet)
Seat 8: 1,1,2,3,5 folded on the Turn
Seat 9: Haek82 folded before Flop (didn't bet)
Seat 10: 1nyyfan folded before Flop (didn't bet)



PokerStars Game #6807695431:  Hold'em Limit ($0.50/$1.00) - 2006/10/28 - 21:00:19 (ET)
Table 'Tanina' 10-max Seat #5 is the button
Seat 1: JMAC60 ($28.55 in chips) 
Seat 2: deepspace68 ($24.95 in chips) 
Seat 3: Rockush420 ($30.35 in chips) 
Seat 4: Diego pb ($4.85 in chips) 
Seat 5: dsa8088 ($17.50 in chips) 
Seat 6: TheoParrish ($14.55 in chips) 
Seat 7: lamb1142 ($15.50 in chips) 
Seat 8: 1,1,2,3,5 ($19 in chips) 
Seat 9: Haek82 ($45.40 in chips) 
Seat 10: 1nyyfan ($19.05 in chips) 
Rockush420 said, "ty"
TheoParrish: posts small blind $0.25
lamb1142: posts big blind $0.50
*** HOLE CARDS ***
Dealt to 1,1,2,3,5 [2c Qh]
1,1,2,3,5: folds 
Haek82: folds 
1nyyfan: folds 
JMAC60: folds 
deepspace68: folds 
Rockush420: folds 
Diego pb: calls $0.50
dsa8088: folds 
TheoParrish: folds 
lamb1142: checks 
*** FLOP *** [Qc 7s Jd]
lamb1142: checks 
Diego pb: bets $0.50
lamb1142: calls $0.50
*** TURN *** [Qc 7s Jd] [4c]
lamb1142: checks 
Diego pb: bets $1
lamb1142: folds 
Diego pb collected $2.15 from pot
Diego pb: doesn't show hand 
*** SUMMARY ***
Total pot $2.25 | Rake $0.10 
Board [Qc 7s Jd 4c]
Seat 1: JMAC60 folded before Flop (didn't bet)
Seat 2: deepspace68 folded before Flop (didn't bet)
Seat 3: Rockush420 folded before Flop (didn't bet)
Seat 4: Diego pb collected ($2.15)
Seat 5: dsa8088 (button) folded before Flop (didn't bet)
Seat 6: TheoParrish (small blind) folded before Flop
Seat 7: lamb1142 (big blind) folded on the Turn
Seat 8: 1,1,2,3,5 folded before Flop (didn't bet)
Seat 9: Haek82 folded before Flop (didn't bet)
Seat 10: 1nyyfan folded before Flop (didn't bet)



PokerStars Game #6807703726:  Hold'em Limit ($0.50/$1.00) - 2006/10/28 - 21:01:01 (ET)
Table 'Tanina' 10-max Seat #6 is the button
Seat 1: JMAC60 ($28.55 in chips) 
Seat 2: deepspace68 ($24.95 in chips) 
Seat 3: Rockush420 ($30.35 in chips) 
Seat 4: Diego pb ($6 in chips) 
Seat 5: dsa8088 ($17.50 in chips) 
Seat 6: TheoParrish ($14.30 in chips) 
Seat 7: lamb1142 ($14.50 in chips) 
Seat 8: 1,1,2,3,5 ($19 in chips) 
Seat 9: Haek82 ($45.40 in chips) 
Seat 10: 1nyyfan ($19.05 in chips) 
lamb1142: posts small blind $0.25
1,1,2,3,5: posts big blind $0.50
*** HOLE CARDS ***
Dealt to 1,1,2,3,5 [7c 8h]
deepspace68 said, "i actually thought we were on a split pot cause you called the raise on the turn"
Haek82: folds 
1nyyfan: folds 
JMAC60: calls $0.50
deepspace68: calls $0.50
Rockush420: folds 
Diego pb: folds 
dsa8088: folds 
TheoParrish: folds 
lamb1142: folds 
1,1,2,3,5: checks 
*** FLOP *** [7d 9d 4c]
1,1,2,3,5: checks 
JMAC60: checks 
deepspace68: checks 
*** TURN *** [7d 9d 4c] [5c]
1,1,2,3,5: checks 
JMAC60: checks 
deepspace68: checks 
*** RIVER *** [7d 9d 4c 5c] [6s]
1,1,2,3,5: bets $1
JMAC60: folds 
deepspace68: folds 
1,1,2,3,5 collected $1.70 from pot
1,1,2,3,5: doesn't show hand 
*** SUMMARY ***
Total pot $1.75 | Rake $0.05 
Board [7d 9d 4c 5c 6s]
Seat 1: JMAC60 folded on the River
Seat 2: deepspace68 folded on the River
Seat 3: Rockush420 folded before Flop (didn't bet)
Seat 4: Diego pb folded before Flop (didn't bet)
Seat 5: dsa8088 folded before Flop (didn't bet)
Seat 6: TheoParrish (button) folded before Flop (didn't bet)
Seat 7: lamb1142 (small blind) folded before Flop
Seat 8: 1,1,2,3,5 (big blind) collected ($1.70)
Seat 9: Haek82 folded before Flop (didn't bet)
Seat 10: 1nyyfan folded before Flop (didn't bet)



PokerStars Game #6807714982:  Hold'em Limit ($0.50/$1.00) - 2006/10/28 - 21:01:55 (ET)
Table 'Tanina' 10-max Seat #7 is the button
Seat 1: JMAC60 ($28.05 in chips) 
Seat 2: deepspace68 ($24.45 in chips) 
Seat 3: Rockush420 ($30.35 in chips) 
Seat 4: Diego pb ($6 in chips) 
Seat 5: dsa8088 ($17.50 in chips) 
Seat 6: TheoParrish ($14.30 in chips) 
Seat 7: lamb1142 ($14.25 in chips) 
Seat 8: 1,1,2,3,5 ($20.20 in chips) 
Seat 9: Haek82 ($45.40 in chips) 
Seat 10: 1nyyfan ($19.05 in chips) 
1,1,2,3,5: posts small blind $0.25
Haek82: posts big blind $0.50
*** HOLE CARDS ***
Dealt to 1,1,2,3,5 [9c 3h]
1nyyfan: folds 
JMAC60: calls $0.50
deepspace68: folds 
Rockush420: calls $0.50
Diego pb: calls $0.50
dsa8088: folds 
TheoParrish: folds 
lamb1142: folds 
1,1,2,3,5: folds 
Haek82: checks 
*** FLOP *** [3s Jc 2h]
Haek82: checks 
JMAC60: checks 
Rockush420: checks 
Diego pb: checks 
*** TURN *** [3s Jc 2h] [5h]
Haek82: bets $1
JMAC60: folds 
Rockush420: calls $1
Diego pb: folds 
*** RIVER *** [3s Jc 2h 5h] [Qs]
Haek82: checks 
Rockush420: checks 
*** SHOW DOWN ***
Haek82: shows [Ac 5d] (a pair of Fives)
Rockush420: shows [6c 6h] (a pair of Sixes)
Rockush420 collected $4.05 from pot
*** SUMMARY ***
Total pot $4.25 | Rake $0.20 
Board [3s Jc 2h 5h Qs]
Seat 1: JMAC60 folded on the Turn
Seat 2: deepspace68 folded before Flop (didn't bet)
Seat 3: Rockush420 showed [6c 6h] and won ($4.05) with a pair of Sixes
Seat 4: Diego pb folded on the Turn
Seat 5: dsa8088 folded before Flop (didn't bet)
Seat 6: TheoParrish folded before Flop (didn't bet)
Seat 7: lamb1142 (button) folded before Flop (didn't bet)
Seat 8: 1,1,2,3,5 (small blind) folded before Flop
Seat 9: Haek82 (big blind) showed [Ac 5d] and lost with a pair of Fives
Seat 10: 1nyyfan folded before Flop (didn't bet)



PokerStars Game #6807725175:  Hold'em Limit ($0.50/$1.00) - 2006/10/28 - 21:02:46 (ET)
Table 'Tanina' 10-max Seat #8 is the button
Seat 1: JMAC60 ($27.55 in chips) 
Seat 2: deepspace68 ($24.45 in chips) 
Seat 3: Rockush420 ($32.90 in chips) 
Seat 4: Diego pb ($5.50 in chips) 
Seat 5: dsa8088 ($17.50 in chips) 
Seat 6: TheoParrish ($14.30 in chips) 
Seat 7: lamb1142 ($14.25 in chips) 
Seat 8: 1,1,2,3,5 ($19.95 in chips) 
Seat 9: Haek82 ($43.90 in chips) 
Seat 10: 1nyyfan ($19.05 in chips) 
Haek82: posts small blind $0.25
1nyyfan: posts big blind $0.50
*** HOLE CARDS ***
Dealt to 1,1,2,3,5 [2h Qh]
JMAC60: folds 
deepspace68: folds 
Rockush420: folds 
Diego pb: folds 
dsa8088: folds 
TheoParrish: folds 
lamb1142: folds 
1,1,2,3,5: folds 
Haek82: raises $0.50 to $1
1nyyfan: calls $0.50
*** FLOP *** [Ts Jc As]
Haek82: checks 
1nyyfan: bets $0.50
Haek82: calls $0.50
*** TURN *** [Ts Jc As] [Kh]
Haek82: checks 
1nyyfan: bets $1
Haek82: raises $1 to $2
1nyyfan: calls $1
*** RIVER *** [Ts Jc As Kh] [Jd]
Haek82: bets $1
1nyyfan: raises $1 to $2
Haek82: raises $1 to $3
1nyyfan: raises $1 to $4
Betting is capped
Haek82: calls $1
*** SHOW DOWN ***
1nyyfan: shows [Ac Ah] (a full house, Aces full of Jacks)
Haek82: shows [Qc 3c] (a straight, Ten to Ace)
1nyyfan collected $14.50 from pot
*** SUMMARY ***
Total pot $15 | Rake $0.50 
Board [Ts Jc As Kh Jd]
Seat 1: JMAC60 folded before Flop (didn't bet)
Seat 2: deepspace68 folded before Flop (didn't bet)
Seat 3: Rockush420 folded before Flop (didn't bet)
Seat 4: Diego pb folded before Flop (didn't bet)
Seat 5: dsa8088 folded before Flop (didn't bet)
Seat 6: TheoParrish folded before Flop (didn't bet)
Seat 7: lamb1142 folded before Flop (didn't bet)
Seat 8: 1,1,2,3,5 (button) folded before Flop (didn't bet)
Seat 9: Haek82 (small blind) showed [Qc 3c] and lost with a straight, Ten to Ace
Seat 10: 1nyyfan (big blind) showed [Ac Ah] and won ($14.50) with a full house, Aces full of Jacks



PokerStars Game #6807733902:  Hold'em Limit ($0.50/$1.00) - 2006/10/28 - 21:03:30 (ET)
Table 'Tanina' 10-max Seat #9 is the button
Seat 1: JMAC60 ($27.55 in chips) 
Seat 2: deepspace68 ($24.45 in chips) 
Seat 3: Rockush420 ($32.90 in chips) 
Seat 4: Diego pb ($5.50 in chips) 
Seat 5: dsa8088 ($17.50 in chips) 
Seat 6: TheoParrish ($14.30 in chips) 
Seat 7: lamb1142 ($14.25 in chips) 
Seat 8: 1,1,2,3,5 ($19.95 in chips) 
Seat 9: Haek82 ($36.40 in chips) 
Seat 10: 1nyyfan ($26.05 in chips) 
1nyyfan: posts small blind $0.25
JMAC60: posts big blind $0.50
*** HOLE CARDS ***
Dealt to 1,1,2,3,5 [Qd 4d]
deepspace68: folds 
Rockush420: folds 
Diego pb: calls $0.50
dsa8088: folds 
TheoParrish: folds 
lamb1142: calls $0.50
Haek82 said, "lucky river"
1,1,2,3,5: folds 
Haek82: folds 
1nyyfan: calls $0.25
JMAC60: checks 
*** FLOP *** [7h 8s 8d]
1nyyfan said, "oh like you did last time??"
1nyyfan: checks 
JMAC60: checks 
Diego pb: checks 
lamb1142: checks 
*** TURN *** [7h 8s 8d] [Tc]
1nyyfan: bets $1
Haek82 said, "now we are even"
JMAC60: folds 
Diego pb: raises $1 to $2
lamb1142: folds 
1nyyfan: calls $1
*** RIVER *** [7h 8s 8d Tc] [9c]
1nyyfan: bets $1
Diego pb: calls $1
*** SHOW DOWN ***
1nyyfan: shows [9h 8c] (a full house, Eights full of Nines)
Diego pb: mucks hand 
1nyyfan collected $7.65 from pot
*** SUMMARY ***
Total pot $8 | Rake $0.35 
Board [7h 8s 8d Tc 9c]
Seat 1: JMAC60 (big blind) folded on the Turn
Seat 2: deepspace68 folded before Flop (didn't bet)
Seat 3: Rockush420 folded before Flop (didn't bet)
Seat 4: Diego pb mucked [3s Ts]
Seat 5: dsa8088 folded before Flop (didn't bet)
Seat 6: TheoParrish folded before Flop (didn't bet)
Seat 7: lamb1142 folded on the Turn
Seat 8: 1,1,2,3,5 folded before Flop (didn't bet)
Seat 9: Haek82 (button) folded before Flop (didn't bet)
Seat 10: 1nyyfan (small blind) showed [9h 8c] and won ($7.65) with a full house, Eights full of Nines



PokerStars Game #6807744562:  Hold'em Limit ($0.50/$1.00) - 2006/10/28 - 21:04:25 (ET)
Table 'Tanina' 10-max Seat #10 is the button
Seat 1: JMAC60 ($27.05 in chips) 
Seat 2: deepspace68 ($24.45 in chips) 
Seat 3: Rockush420 ($32.90 in chips) 
Seat 4: Diego pb ($2 in chips) 
Seat 5: dsa8088 ($17.50 in chips) 
Seat 6: TheoParrish ($14.30 in chips) 
Seat 7: lamb1142 ($13.75 in chips) 
Seat 8: 1,1,2,3,5 ($19.95 in chips) 
Seat 9: Haek82 ($36.40 in chips) 
Seat 10: 1nyyfan ($30.20 in chips) 
JMAC60: posts small blind $0.25
deepspace68: posts big blind $0.50
*** HOLE CARDS ***
Dealt to 1,1,2,3,5 [Tc Ah]
Diego pb said, "hhah"
Rockush420: folds 
Diego pb: calls $0.50
dsa8088: folds 
TheoParrish: folds 
lamb1142: folds 
1,1,2,3,5: calls $0.50
Haek82: calls $0.50
1nyyfan: calls $0.50
JMAC60: folds 
deepspace68: checks 
*** FLOP *** [5h Qc Ks]
deepspace68: checks 
Diego pb: checks 
1,1,2,3,5: bets $0.50
Haek82: calls $0.50
1nyyfan: folds 
deepspace68: folds 
Diego pb: folds 
*** TURN *** [5h Qc Ks] [Qs]
1,1,2,3,5: checks 
Haek82: bets $1
1,1,2,3,5: calls $1
*** RIVER *** [5h Qc Ks Qs] [9d]
1,1,2,3,5: checks 
Haek82: checks 
*** SHOW DOWN ***
1,1,2,3,5: shows [Tc Ah] (a pair of Queens)
Haek82: shows [6h Kh] (two pair, Kings and Queens)
Haek82 collected $5.50 from pot
*** SUMMARY ***
Total pot $5.75 | Rake $0.25 
Board [5h Qc Ks Qs 9d]
Seat 1: JMAC60 (small blind) folded before Flop
Seat 2: deepspace68 (big blind) folded on the Flop
Seat 3: Rockush420 folded before Flop (didn't bet)
Seat 4: Diego pb folded on the Flop
Seat 5: dsa8088 folded before Flop (didn't bet)
Seat 6: TheoParrish folded before Flop (didn't bet)
Seat 7: lamb1142 folded before Flop (didn't bet)
Seat 8: 1,1,2,3,5 showed [Tc Ah] and lost with a pair of Queens
Seat 9: Haek82 showed [6h Kh] and won ($5.50) with two pair, Kings and Queens
Seat 10: 1nyyfan (button) folded on the Flop



PokerStars Game #6807755064:  Hold'em Limit ($0.50/$1.00) - 2006/10/28 - 21:05:18 (ET)
Table 'Tanina' 10-max Seat #1 is the button
Seat 1: JMAC60 ($26.80 in chips) 
Seat 2: deepspace68 ($23.95 in chips) 
Seat 3: Rockush420 ($32.90 in chips) 
Seat 4: Diego pb ($1.50 in chips) 
Seat 5: dsa8088 ($17.50 in chips) 
Seat 6: TheoParrish ($14.30 in chips) 
Seat 7: lamb1142 ($13.75 in chips) 
Seat 8: 1,1,2,3,5 ($17.95 in chips) 
Seat 9: Haek82 ($39.90 in chips) 
Seat 10: 1nyyfan ($29.70 in chips) 
deepspace68: posts small blind $0.25
Rockush420: posts big blind $0.50
*** HOLE CARDS ***
Dealt to 1,1,2,3,5 [6h Qd]
Diego pb: calls $0.50
dsa8088: raises $0.50 to $1
TheoParrish: folds 
lamb1142: folds 
1,1,2,3,5: folds 
Haek82: folds 
1nyyfan: calls $1
JMAC60: folds 
deepspace68: calls $0.75
Rockush420: calls $0.50
Diego pb: raises $0.50 to $1.50 and is all-in
dsa8088: calls $0.50
1nyyfan: calls $0.50
deepspace68: calls $0.50
Rockush420: calls $0.50
*** FLOP *** [Kd Th Jh]
dsa8088 said, "call"
dsa8088 said, "call"
deepspace68: checks 
dsa8088 said, "call"
Rockush420: checks 
dsa8088: bets $0.50
1nyyfan: folds 
deepspace68: calls $0.50
Rockush420: calls $0.50
*** TURN *** [Kd Th Jh] [7s]
deepspace68: checks 
Rockush420: checks 
dsa8088: bets $1
deepspace68: calls $1
Rockush420: calls $1
*** RIVER *** [Kd Th Jh 7s] [Jc]
deepspace68: checks 
Rockush420: checks 
dsa8088: bets $1
deepspace68: calls $1
Rockush420: folds 
*** SHOW DOWN ***
dsa8088: shows [As Jd] (three of a kind, Jacks)
deepspace68: shows [Ad Js] (three of a kind, Jacks)
deepspace68 collected $3.20 from side pot
dsa8088 collected $3.15 from side pot
Diego pb: mucks hand 
Diego pb leaves the table
deepspace68 collected $3.60 from main pot
dsa8088 collected $3.55 from main pot
*** SUMMARY ***
Total pot $14 Main pot $7.15. Side pot $6.35. | Rake $0.50 
Board [Kd Th Jh 7s Jc]
Seat 1: JMAC60 (button) folded before Flop (didn't bet)
Seat 2: deepspace68 (small blind) showed [Ad Js] and won ($6.80) with three of a kind, Jacks
Seat 3: Rockush420 (big blind) folded on the River
Seat 4: Diego pb mucked [6c Qh]
Seat 5: dsa8088 showed [As Jd] and won ($6.70) with three of a kind, Jacks
Seat 6: TheoParrish folded before Flop (didn't bet)
Seat 7: lamb1142 folded before Flop (didn't bet)
Seat 8: 1,1,2,3,5 folded before Flop (didn't bet)
Seat 9: Haek82 folded before Flop (didn't bet)
Seat 10: 1nyyfan folded on the Flop



PokerStars Game #6807769879:  Hold'em Limit ($0.50/$1.00) - 2006/10/28 - 21:06:32 (ET)
Table 'Tanina' 10-max Seat #2 is the button
Seat 1: JMAC60 ($26.80 in chips) 
Seat 2: deepspace68 ($26.75 in chips) 
Seat 3: Rockush420 ($29.90 in chips) 
Seat 5: dsa8088 ($20.20 in chips) 
Seat 6: TheoParrish ($14.30 in chips) 
Seat 7: lamb1142 ($13.75 in chips) 
Seat 8: 1,1,2,3,5 ($17.95 in chips) 
Seat 9: Haek82 ($39.90 in chips) 
Seat 10: 1nyyfan ($28.20 in chips) 
Rockush420: posts small blind $0.25
dsa8088: posts big blind $0.50
*** HOLE CARDS ***
Dealt to 1,1,2,3,5 [Kc 3s]
TheoParrish: folds 
lamb1142: folds 
1,1,2,3,5: folds 
Haek82: folds 
1nyyfan: calls $0.50
JMAC60: calls $0.50
deepspace68: calls $0.50
dsa8088 said, "nice call"
Rockush420: calls $0.25
dsa8088: checks 
*** FLOP *** [4s 2h 5h]
Rockush420: checks 
dsa8088: checks 
1nyyfan: checks 
JMAC60: checks 
deepspace68 said, "same..."
deepspace68: checks 
*** TURN *** [4s 2h 5h] [2d]
Rockush420: checks 
dsa8088: bets $1
1nyyfan: folds 
JMAC60: folds 
deepspace68: folds 
Rockush420: folds 
dsa8088 collected $2.40 from pot
dsa8088 is sitting out
dsa8088: doesn't show hand 
*** SUMMARY ***
Total pot $2.50 | Rake $0.10 
Board [4s 2h 5h 2d]
Seat 1: JMAC60 folded on the Turn
Seat 2: deepspace68 (button) folded on the Turn
Seat 3: Rockush420 (small blind) folded on the Turn
Seat 5: dsa8088 (big blind) collected ($2.40)
Seat 6: TheoParrish folded before Flop (didn't bet)
Seat 7: lamb1142 folded before Flop (didn't bet)
Seat 8: 1,1,2,3,5 folded before Flop (didn't bet)
Seat 9: Haek82 folded before Flop (didn't bet)
Seat 10: 1nyyfan folded on the Turn



PokerStars Game #6807780525:  Hold'em Limit ($0.50/$1.00) - 2006/10/28 - 21:07:24 (ET)
Table 'Tanina' 10-max Seat #3 is the button
Seat 1: JMAC60 ($26.30 in chips) 
Seat 2: deepspace68 ($26.25 in chips) 
Seat 3: Rockush420 ($29.40 in chips) 
Seat 6: TheoParrish ($14.30 in chips) 
Seat 7: lamb1142 ($13.75 in chips) 
Seat 8: 1,1,2,3,5 ($17.95 in chips) 
Seat 9: Haek82 ($39.90 in chips) 
Seat 10: 1nyyfan ($27.70 in chips) 
TheoParrish: posts small blind $0.25
lamb1142: posts big blind $0.50
*** HOLE CARDS ***
Dealt to 1,1,2,3,5 [6h Qc]
1,1,2,3,5: folds 
dsa8088 leaves the table
Haek82: folds 
1nyyfan: folds 
JMAC60: folds 
deepspace68: folds 
Rockush420: raises $0.50 to $1
TheoParrish: folds 
lamb1142: calls $0.50
*** FLOP *** [Js 4s 5s]
lamb1142: checks 
Rockush420: bets $0.50
lamb1142: calls $0.50
*** TURN *** [Js 4s 5s] [Tc]
lamb1142: checks 
Rockush420: bets $1
lamb1142: folds 
Rockush420 collected $3.10 from pot
*** SUMMARY ***
Total pot $3.25 | Rake $0.15 
Board [Js 4s 5s Tc]
Seat 1: JMAC60 folded before Flop (didn't bet)
Seat 2: deepspace68 folded before Flop (didn't bet)
Seat 3: Rockush420 (button) collected ($3.10)
Seat 6: TheoParrish (small blind) folded before Flop
Seat 7: lamb1142 (big blind) folded on the Turn
Seat 8: 1,1,2,3,5 folded before Flop (didn't bet)
Seat 9: Haek82 folded before Flop (didn't bet)
Seat 10: 1nyyfan folded before Flop (didn't bet)



PokerStars Game #6807787935:  Hold'em Limit ($0.50/$1.00) - 2006/10/28 - 21:08:01 (ET)
Table 'Tanina' 10-max Seat #6 is the button
Seat 1: JMAC60 ($26.30 in chips) 
Seat 2: deepspace68 ($26.25 in chips) 
Seat 3: Rockush420 ($31 in chips) 
Seat 6: TheoParrish ($14.05 in chips) 
Seat 7: lamb1142 ($12.25 in chips) 
Seat 8: 1,1,2,3,5 ($17.95 in chips) 
Seat 9: Haek82 ($39.90 in chips) 
Seat 10: 1nyyfan ($27.70 in chips) 
lamb1142: posts small blind $0.25
1,1,2,3,5: posts big blind $0.50
*** HOLE CARDS ***
Dealt to 1,1,2,3,5 [Qc Th]
Haek82: folds 
1nyyfan: folds 
JMAC60: folds 
deepspace68: folds 
Rockush420: folds 
TheoParrish: raises $0.50 to $1
lamb1142: folds 
1,1,2,3,5: folds 
TheoParrish collected $1.25 from pot
TheoParrish: doesn't show hand 
*** SUMMARY ***
Total pot $1.25 | Rake $0 
Seat 1: JMAC60 folded before Flop (didn't bet)
Seat 2: deepspace68 folded before Flop (didn't bet)
Seat 3: Rockush420 folded before Flop (didn't bet)
Seat 6: TheoParrish (button) collected ($1.25)
Seat 7: lamb1142 (small blind) folded before Flop
Seat 8: 1,1,2,3,5 (big blind) folded before Flop
Seat 9: Haek82 folded before Flop (didn't bet)
Seat 10: 1nyyfan folded before Flop (didn't bet)



PokerStars Game #6807792612:  Hold'em Limit ($0.50/$1.00) - 2006/10/28 - 21:08:24 (ET)
Table 'Tanina' 10-max Seat #7 is the button
Seat 1: JMAC60 ($26.30 in chips) 
Seat 2: deepspace68 ($26.25 in chips) 
Seat 3: Rockush420 ($31 in chips) 
Seat 6: TheoParrish ($14.80 in chips) 
Seat 7: lamb1142 ($12 in chips) 
Seat 8: 1,1,2,3,5 ($17.45 in chips) 
Seat 9: Haek82 ($39.90 in chips) 
Seat 10: 1nyyfan ($27.70 in chips) 
1,1,2,3,5: posts small blind $0.25
Haek82: posts big blind $0.50
*** HOLE CARDS ***
Dealt to 1,1,2,3,5 [7d 9h]
1nyyfan: folds 
JMAC60: folds 
deepspace68: folds 
Rockush420: folds 
TheoParrish: raises $0.50 to $1
lamb1142: calls $1
1,1,2,3,5: folds 
Haek82: calls $0.50
*** FLOP *** [Tc 5c 8h]
Haek82: checks 
TheoParrish: bets $0.50
lamb1142: folds 
Haek82: calls $0.50
*** TURN *** [Tc 5c 8h] [9s]
Haek82: checks 
TheoParrish: bets $1
Haek82: calls $1
*** RIVER *** [Tc 5c 8h 9s] [Js]
Haek82: checks 
TheoParrish: bets $1
Haek82: calls $1
*** SHOW DOWN ***
TheoParrish: shows [Jh Th] (two pair, Jacks and Tens)
Haek82: mucks hand 
TheoParrish collected $7.90 from pot
*** SUMMARY ***
Total pot $8.25 | Rake $0.35 
Board [Tc 5c 8h 9s Js]
Seat 1: JMAC60 folded before Flop (didn't bet)
Seat 2: deepspace68 folded before Flop (didn't bet)
Seat 3: Rockush420 folded before Flop (didn't bet)
Seat 6: TheoParrish showed [Jh Th] and won ($7.90) with two pair, Jacks and Tens
Seat 7: lamb1142 (button) folded on the Flop
Seat 8: 1,1,2,3,5 (small blind) folded before Flop
Seat 9: Haek82 (big blind) mucked [3c 9c]
Seat 10: 1nyyfan folded before Flop (didn't bet)



PokerStars Game #6807801341:  Hold'em Limit ($0.50/$1.00) - 2006/10/28 - 21:09:05 (ET)
Table 'Tanina' 10-max Seat #8 is the button
Seat 1: JMAC60 ($26.30 in chips) 
Seat 2: deepspace68 ($26.25 in chips) 
Seat 3: Rockush420 ($31 in chips) 
Seat 6: TheoParrish ($19.20 in chips) 
Seat 7: lamb1142 ($11 in chips) 
Seat 8: 1,1,2,3,5 ($17.20 in chips) 
Seat 9: Haek82 ($36.40 in chips) 
Seat 10: 1nyyfan ($27.70 in chips) 
Haek82: posts small blind $0.25
1nyyfan: posts big blind $0.50
*** HOLE CARDS ***
Dealt to 1,1,2,3,5 [9h 6s]
JMAC60: folds 
deepspace68: folds 
Rockush420: folds 
TheoParrish: folds 
lamb1142: folds 
1,1,2,3,5: folds 
Haek82: folds 
1nyyfan collected $0.50 from pot
1nyyfan: doesn't show hand 
*** SUMMARY ***
Total pot $0.50 | Rake $0 
Seat 1: JMAC60 folded before Flop (didn't bet)
Seat 2: deepspace68 folded before Flop (didn't bet)
Seat 3: Rockush420 folded before Flop (didn't bet)
Seat 6: TheoParrish folded before Flop (didn't bet)
Seat 7: lamb1142 folded before Flop (didn't bet)
Seat 8: 1,1,2,3,5 (button) folded before Flop (didn't bet)
Seat 9: Haek82 (small blind) folded before Flop
Seat 10: 1nyyfan (big blind) collected ($0.50)



PokerStars Game #6807803985:  Hold'em Limit ($0.50/$1.00) - 2006/10/28 - 21:09:18 (ET)
Table 'Tanina' 10-max Seat #9 is the button
Seat 1: JMAC60 ($26.30 in chips) 
Seat 2: deepspace68 ($26.25 in chips) 
Seat 3: Rockush420 ($31 in chips) 
Seat 6: TheoParrish ($19.20 in chips) 
Seat 7: lamb1142 ($11 in chips) 
Seat 8: 1,1,2,3,5 ($17.20 in chips) 
Seat 9: Haek82 ($36.15 in chips) 
Seat 10: 1nyyfan ($27.95 in chips) 
1nyyfan: posts small blind $0.25
JMAC60: posts big blind $0.50
*** HOLE CARDS ***
Dealt to 1,1,2,3,5 [Ac Td]
deepspace68: folds 
Rockush420: folds 
TheoParrish: folds 
lamb1142: folds 
1,1,2,3,5: calls $0.50
Haek82: folds 
1nyyfan: calls $0.25
JMAC60: checks 
*** FLOP *** [6c Ah 2s]
1nyyfan: checks 
JMAC60: checks 
1,1,2,3,5: bets $0.50
1nyyfan: folds 
JMAC60: folds 
1,1,2,3,5 collected $1.45 from pot
*** SUMMARY ***
Total pot $1.50 | Rake $0.05 
Board [6c Ah 2s]
Seat 1: JMAC60 (big blind) folded on the Flop
Seat 2: deepspace68 folded before Flop (didn't bet)
Seat 3: Rockush420 folded before Flop (didn't bet)
Seat 6: TheoParrish folded before Flop (didn't bet)
Seat 7: lamb1142 folded before Flop (didn't bet)
Seat 8: 1,1,2,3,5 collected ($1.45)
Seat 9: Haek82 (button) folded before Flop (didn't bet)
Seat 10: 1nyyfan (small blind) folded on the Flop



PokerStars Game #6807809255:  Hold'em Limit ($0.50/$1.00) - 2006/10/28 - 21:09:43 (ET)
Table 'Tanina' 10-max Seat #10 is the button
Seat 1: JMAC60 ($25.80 in chips) 
Seat 2: deepspace68 ($26.25 in chips) 
Seat 3: Rockush420 ($31 in chips) 
Seat 6: TheoParrish ($19.20 in chips) 
Seat 7: lamb1142 ($11 in chips) 
Seat 8: 1,1,2,3,5 ($18.15 in chips) 
Seat 9: Haek82 ($36.15 in chips) 
Seat 10: 1nyyfan ($27.45 in chips) 
JMAC60: posts small blind $0.25
deepspace68: posts big blind $0.50
*** HOLE CARDS ***
Dealt to 1,1,2,3,5 [4d 5h]
Rockush420: folds 
TheoParrish: folds 
lamb1142: calls $0.50
1,1,2,3,5: folds 
Haek82: calls $0.50
1nyyfan: folds 
JMAC60: folds 
deepspace68: checks 
*** FLOP *** [Kc 8h 7d]
deepspace68: checks 
lamb1142: bets $0.50
Haek82: calls $0.50
deepspace68: folds 
*** TURN *** [Kc 8h 7d] [3c]
lamb1142: bets $1
Haek82: folds 
lamb1142 collected $2.65 from pot
*** SUMMARY ***
Total pot $2.75 | Rake $0.10 
Board [Kc 8h 7d 3c]
Seat 1: JMAC60 (small blind) folded before Flop
Seat 2: deepspace68 (big blind) folded on the Flop
Seat 3: Rockush420 folded before Flop (didn't bet)
Seat 6: TheoParrish folded before Flop (didn't bet)
Seat 7: lamb1142 collected ($2.65)
Seat 8: 1,1,2,3,5 folded before Flop (didn't bet)
Seat 9: Haek82 folded on the Turn
Seat 10: 1nyyfan (button) folded before Flop (didn't bet)



PokerStars Game #6807816949:  Hold'em Limit ($0.50/$1.00) - 2006/10/28 - 21:10:19 (ET)
Table 'Tanina' 10-max Seat #1 is the button
Seat 1: JMAC60 ($25.55 in chips) 
Seat 2: deepspace68 ($25.75 in chips) 
Seat 3: Rockush420 ($31 in chips) 
Seat 6: TheoParrish ($19.20 in chips) 
Seat 7: lamb1142 ($12.65 in chips) 
Seat 8: 1,1,2,3,5 ($18.15 in chips) 
Seat 9: Haek82 ($35.15 in chips) 
Seat 10: 1nyyfan ($27.45 in chips) 
deepspace68: posts small blind $0.25
Rockush420: posts big blind $0.50
*** HOLE CARDS ***
Dealt to 1,1,2,3,5 [2h 6h]
TheoParrish: folds 
lamb1142: folds 
1,1,2,3,5: folds 
Haek82: raises $0.50 to $1
1nyyfan: folds 
JMAC60: folds 
deepspace68: folds 
Rockush420: folds 
Glide Or joins the table at seat #5 
Haek82 collected $1.25 from pot
*** SUMMARY ***
Total pot $1.25 | Rake $0 
Seat 1: JMAC60 (button) folded before Flop (didn't bet)
Seat 2: deepspace68 (small blind) folded before Flop
Seat 3: Rockush420 (big blind) folded before Flop
Seat 6: TheoParrish folded before Flop (didn't bet)
Seat 7: lamb1142 folded before Flop (didn't bet)
Seat 8: 1,1,2,3,5 folded before Flop (didn't bet)
Seat 9: Haek82 collected ($1.25)
Seat 10: 1nyyfan folded before Flop (didn't bet)



PokerStars Game #6807820604:  Hold'em Limit ($0.50/$1.00) - 2006/10/28 - 21:10:37 (ET)
Table 'Tanina' 10-max Seat #2 is the button
Seat 1: JMAC60 ($25.55 in chips) 
Seat 2: deepspace68 ($25.50 in chips) 
Seat 3: Rockush420 ($30.50 in chips) 
Seat 5: Glide Or ($20 in chips) 
Seat 6: TheoParrish ($19.20 in chips) 
Seat 7: lamb1142 ($12.65 in chips) 
Seat 8: 1,1,2,3,5 ($18.15 in chips) 
Seat 9: Haek82 ($35.90 in chips) 
Seat 10: 1nyyfan ($27.45 in chips) 
Rockush420: posts small blind $0.25
Glide Or: posts big blind $0.50
*** HOLE CARDS ***
Dealt to 1,1,2,3,5 [Th 8h]
TheoParrish: folds 
lamb1142: folds 
1,1,2,3,5: folds 
Haek82: folds 
1nyyfan: folds 
JMAC60: raises $0.50 to $1
deepspace68: folds 
Rockush420: folds 
Glide Or: calls $0.50
*** FLOP *** [6c Kh 7d]
Glide Or: checks 
JMAC60: bets $0.50
Glide Or: folds 
JMAC60 collected $2.15 from pot
JMAC60: doesn't show hand 
*** SUMMARY ***
Total pot $2.25 | Rake $0.10 
Board [6c Kh 7d]
Seat 1: JMAC60 collected ($2.15)
Seat 2: deepspace68 (button) folded before Flop (didn't bet)
Seat 3: Rockush420 (small blind) folded before Flop
Seat 5: Glide Or (big blind) folded on the Flop
Seat 6: TheoParrish folded before Flop (didn't bet)
Seat 7: lamb1142 folded before Flop (didn't bet)
Seat 8: 1,1,2,3,5 folded before Flop (didn't bet)
Seat 9: Haek82 folded before Flop (didn't bet)
Seat 10: 1nyyfan folded before Flop (didn't bet)



PokerStars Game #6807828410:  Hold'em Limit ($0.50/$1.00) - 2006/10/28 - 21:11:14 (ET)
Table 'Tanina' 10-max Seat #3 is the button
Seat 1: JMAC60 ($26.70 in chips) 
Seat 2: deepspace68 ($25.50 in chips) 
Seat 3: Rockush420 ($30.25 in chips) 
Seat 5: Glide Or ($19 in chips) 
Seat 6: TheoParrish ($19.20 in chips) 
Seat 7: lamb1142 ($12.65 in chips) 
Seat 8: 1,1,2,3,5 ($18.15 in chips) 
Seat 9: Haek82 ($35.90 in chips) 
Seat 10: 1nyyfan ($27.45 in chips) 
Glide Or: posts small blind $0.25
TheoParrish: posts big blind $0.50
*** HOLE CARDS ***
Dealt to 1,1,2,3,5 [Qd 8h]
lamb1142: calls $0.50
1,1,2,3,5: folds 
Haek82: calls $0.50
1nyyfan: folds 
JMAC60: folds 
deepspace68: calls $0.50
Rockush420: folds 
Glide Or: calls $0.25
TheoParrish: checks 
*** FLOP *** [6d Jc Jd]
Glide Or: checks 
TheoParrish: checks 
lamb1142: bets $0.50
Haek82: calls $0.50
deepspace68: folds 
Glide Or: calls $0.50
TheoParrish: folds 
*** TURN *** [6d Jc Jd] [2c]
Glide Or: checks 
lamb1142: bets $1
Haek82: calls $1
Glide Or: calls $1
*** RIVER *** [6d Jc Jd 2c] [5c]
Glide Or: checks 
lamb1142: bets $1
Haek82: raises $1 to $2
Glide Or: folds 
lamb1142: calls $1
*** SHOW DOWN ***
Haek82: shows [Jh 9h] (three of a kind, Jacks)
lamb1142: shows [Ad Js] (three of a kind, Jacks - Ace kicker)
lamb1142 collected $10.50 from pot
*** SUMMARY ***
Total pot $11 | Rake $0.50 
Board [6d Jc Jd 2c 5c]
Seat 1: JMAC60 folded before Flop (didn't bet)
Seat 2: deepspace68 folded on the Flop
Seat 3: Rockush420 (button) folded before Flop (didn't bet)
Seat 5: Glide Or (small blind) folded on the River
Seat 6: TheoParrish (big blind) folded on the Flop
Seat 7: lamb1142 showed [Ad Js] and won ($10.50) with three of a kind, Jacks
Seat 8: 1,1,2,3,5 folded before Flop (didn't bet)
Seat 9: Haek82 showed [Jh 9h] and lost with three of a kind, Jacks
Seat 10: 1nyyfan folded before Flop (didn't bet)



PokerStars Game #6807842828:  Hold'em Limit ($0.50/$1.00) - 2006/10/28 - 21:12:24 (ET)
Table 'Tanina' 10-max Seat #5 is the button
Seat 1: JMAC60 ($26.70 in chips) 
Seat 2: deepspace68 ($25 in chips) 
Seat 3: Rockush420 ($30.25 in chips) 
Seat 5: Glide Or ($17 in chips) 
Seat 6: TheoParrish ($18.70 in chips) 
Seat 7: lamb1142 ($19.15 in chips) 
Seat 8: 1,1,2,3,5 ($18.15 in chips) 
Seat 9: Haek82 ($31.90 in chips) 
Seat 10: 1nyyfan ($27.45 in chips) 
TheoParrish: posts small blind $0.25
lamb1142: posts big blind $0.50
*** HOLE CARDS ***
Dealt to 1,1,2,3,5 [5d Qd]
1,1,2,3,5: folds 
Haek82: raises $0.50 to $1
1nyyfan: folds 
JMAC60: folds 
deepspace68: folds 
Rockush420: calls $1
Glide Or: calls $1
TheoParrish: folds 
lamb1142: folds 
*** FLOP *** [4c 3c 4d]
Haek82: bets $0.50
Rockush420: calls $0.50
Glide Or: calls $0.50
*** TURN *** [4c 3c 4d] [2c]
Haek82: bets $1
Rockush420: folds 
Glide Or: calls $1
*** RIVER *** [4c 3c 4d 2c] [Jh]
Haek82: checks 
Glide Or: checks 
*** SHOW DOWN ***
Haek82: shows [Tc Ac] (a flush, Ace high)
Glide Or: shows [6s 6h] (two pair, Sixes and Fours)
Haek82 collected $6.90 from pot
*** SUMMARY ***
Total pot $7.25 | Rake $0.35 
Board [4c 3c 4d 2c Jh]
Seat 1: JMAC60 folded before Flop (didn't bet)
Seat 2: deepspace68 folded before Flop (didn't bet)
Seat 3: Rockush420 folded on the Turn
Seat 5: Glide Or (button) showed [6s 6h] and lost with two pair, Sixes and Fours
Seat 6: TheoParrish (small blind) folded before Flop
Seat 7: lamb1142 (big blind) folded before Flop
Seat 8: 1,1,2,3,5 folded before Flop (didn't bet)
Seat 9: Haek82 showed [Tc Ac] and won ($6.90) with a flush, Ace high
Seat 10: 1nyyfan folded before Flop (didn't bet)



PokerStars Game #6807851847:  Hold'em Limit ($0.50/$1.00) - 2006/10/28 - 21:13:07 (ET)
Table 'Tanina' 10-max Seat #6 is the button
Seat 1: JMAC60 ($26.70 in chips) 
Seat 2: deepspace68 ($25 in chips) 
Seat 3: Rockush420 ($28.75 in chips) 
Seat 5: Glide Or ($14.50 in chips) 
Seat 6: TheoParrish ($18.45 in chips) 
Seat 7: lamb1142 ($18.65 in chips) 
Seat 8: 1,1,2,3,5 ($18.15 in chips) 
Seat 9: Haek82 ($36.30 in chips) 
Seat 10: 1nyyfan ($27.45 in chips) 
lamb1142: posts small blind $0.25
1,1,2,3,5: posts big blind $0.50
*** HOLE CARDS ***
Dealt to 1,1,2,3,5 [Th 6h]
Haek82: folds 
1nyyfan: folds 
JMAC60: folds 
deepspace68: calls $0.50
Rockush420: calls $0.50
Glide Or: calls $0.50
TheoParrish: folds 
lamb1142: folds 
1,1,2,3,5: checks 
*** FLOP *** [5c 2s Ah]
1,1,2,3,5: checks 
deepspace68: checks 
Rockush420: checks 
Glide Or: checks 
*** TURN *** [5c 2s Ah] [7h]
1,1,2,3,5: checks 
deepspace68: checks 
Rockush420: checks 
Glide Or: bets $1
1,1,2,3,5: calls $1
deepspace68: folds 
Rockush420: folds 
*** RIVER *** [5c 2s Ah 7h] [3s]
1,1,2,3,5: checks 
Glide Or: bets $1
1,1,2,3,5: folds 
Glide Or collected $4.05 from pot
*** SUMMARY ***
Total pot $4.25 | Rake $0.20 
Board [5c 2s Ah 7h 3s]
Seat 1: JMAC60 folded before Flop (didn't bet)
Seat 2: deepspace68 folded on the Turn
Seat 3: Rockush420 folded on the Turn
Seat 5: Glide Or collected ($4.05)
Seat 6: TheoParrish (button) folded before Flop (didn't bet)
Seat 7: lamb1142 (small blind) folded before Flop
Seat 8: 1,1,2,3,5 (big blind) folded on the River
Seat 9: Haek82 folded before Flop (didn't bet)
Seat 10: 1nyyfan folded before Flop (didn't bet)



PokerStars Game #6807860854:  Hold'em Limit ($0.50/$1.00) - 2006/10/28 - 21:13:49 (ET)
Table 'Tanina' 10-max Seat #7 is the button
Seat 1: JMAC60 ($26.70 in chips) 
Seat 2: deepspace68 ($24.50 in chips) 
Seat 3: Rockush420 ($28.25 in chips) 
Seat 5: Glide Or ($17.05 in chips) 
Seat 6: TheoParrish ($18.45 in chips) 
Seat 7: lamb1142 ($18.40 in chips) 
Seat 8: 1,1,2,3,5 ($16.65 in chips) 
Seat 9: Haek82 ($36.30 in chips) 
Seat 10: 1nyyfan ($27.45 in chips) 
1,1,2,3,5: posts small blind $0.25
Haek82: posts big blind $0.50
*** HOLE CARDS ***
Dealt to 1,1,2,3,5 [9d 8d]
1nyyfan: folds 
JMAC60: raises $0.50 to $1
deepspace68: calls $1
Rockush420: folds 
Glide Or: calls $1
TheoParrish: folds 
lamb1142: calls $1
1,1,2,3,5: folds 
Haek82: folds 
*** FLOP *** [Qd Qs Qh]
JMAC60: bets $0.50
deepspace68: calls $0.50
Glide Or: folds 
lamb1142: calls $0.50
*** TURN *** [Qd Qs Qh] [Tc]
JMAC60: bets $1
deepspace68: calls $1
lamb1142: calls $1
*** RIVER *** [Qd Qs Qh Tc] [Ad]
JMAC60: bets $1
deepspace68: raises $1 to $2
lamb1142: calls $2
JMAC60: calls $1
*** SHOW DOWN ***
deepspace68: shows [Qc Jc] (four of a kind, Queens)
lamb1142: mucks hand 
JMAC60: mucks hand 
deepspace68 collected $14.75 from pot
*** SUMMARY ***
Total pot $15.25 | Rake $0.50 
Board [Qd Qs Qh Tc Ad]
Seat 1: JMAC60 mucked [As Js]
Seat 2: deepspace68 showed [Qc Jc] and won ($14.75) with four of a kind, Queens
Seat 3: Rockush420 folded before Flop (didn't bet)
Seat 5: Glide Or folded on the Flop
Seat 6: TheoParrish folded before Flop (didn't bet)
Seat 7: lamb1142 (button) mucked [Kc Ac]
Seat 8: 1,1,2,3,5 (small blind) folded before Flop
Seat 9: Haek82 (big blind) folded before Flop
Seat 10: 1nyyfan folded before Flop (didn't bet)



PokerStars Game #6807872999:  Hold'em Limit ($0.50/$1.00) - 2006/10/28 - 21:14:47 (ET)
Table 'Tanina' 10-max Seat #8 is the button
Seat 1: JMAC60 ($22.20 in chips) 
Seat 2: deepspace68 ($34.75 in chips) 
Seat 3: Rockush420 ($28.25 in chips) 
Seat 5: Glide Or ($16.05 in chips) 
Seat 6: TheoParrish ($18.45 in chips) 
Seat 7: lamb1142 ($13.90 in chips) 
Seat 8: 1,1,2,3,5 ($16.40 in chips) 
Seat 9: Haek82 ($35.80 in chips) 
Seat 10: 1nyyfan ($27.45 in chips) 
Haek82: posts small blind $0.25
1nyyfan: posts big blind $0.50
*** HOLE CARDS ***
Dealt to 1,1,2,3,5 [3c 7h]
JMAC60: folds 
deepspace68: folds 
Rockush420: raises $0.50 to $1
Glide Or: folds 
TheoParrish: folds 
lamb1142: calls $1
1,1,2,3,5: folds 
Haek82: raises $0.50 to $1.50
1nyyfan: calls $1
Rockush420: calls $0.50
lamb1142: calls $0.50
*** FLOP *** [9s 4d 9c]
Haek82: bets $0.50
1nyyfan: folds 
Rockush420: calls $0.50
lamb1142: calls $0.50
*** TURN *** [9s 4d 9c] [5h]
Haek82: bets $1
Rockush420: calls $1
lamb1142: calls $1
*** RIVER *** [9s 4d 9c 5h] [As]
Haek82: bets $1
Rockush420: calls $1
lamb1142: calls $1
*** SHOW DOWN ***
Haek82: shows [Kh Kc] (two pair, Kings and Nines)
Rockush420: mucks hand 
lamb1142: shows [Td Ac] (two pair, Aces and Nines)
lamb1142 collected $13 from pot
*** SUMMARY ***
Total pot $13.50 | Rake $0.50 
Board [9s 4d 9c 5h As]
Seat 1: JMAC60 folded before Flop (didn't bet)
Seat 2: deepspace68 folded before Flop (didn't bet)
Seat 3: Rockush420 mucked [7d 7c]
Seat 5: Glide Or folded before Flop (didn't bet)
Seat 6: TheoParrish folded before Flop (didn't bet)
Seat 7: lamb1142 showed [Td Ac] and won ($13) with two pair, Aces and Nines
Seat 8: 1,1,2,3,5 (button) folded before Flop (didn't bet)
Seat 9: Haek82 (small blind) showed [Kh Kc] and lost with two pair, Kings and Nines
Seat 10: 1nyyfan (big blind) folded on the Flop



PokerStars Game #6807886340:  Hold'em Limit ($0.50/$1.00) - 2006/10/28 - 21:15:53 (ET)
Table 'Tanina' 10-max Seat #9 is the button
Seat 1: JMAC60 ($22.20 in chips) 
Seat 2: deepspace68 ($34.75 in chips) 
Seat 3: Rockush420 ($24.25 in chips) 
Seat 5: Glide Or ($16.05 in chips) 
Seat 6: TheoParrish ($18.45 in chips) 
Seat 7: lamb1142 ($22.90 in chips) 
Seat 8: 1,1,2,3,5 ($16.40 in chips) 
Seat 9: Haek82 ($31.80 in chips) 
Seat 10: 1nyyfan ($25.95 in chips) 
1nyyfan: posts small blind $0.25
JMAC60: posts big blind $0.50
*** HOLE CARDS ***
Dealt to 1,1,2,3,5 [3h 2c]
deepspace68: folds 
Rockush420: calls $0.50
Glide Or: calls $0.50
TheoParrish: folds 
lamb1142: folds 
1,1,2,3,5: folds 
Haek82: folds 
1nyyfan: calls $0.25
Haek82 said, "river stars"
JMAC60: raises $0.50 to $1
1nyyfan said, "wtf?"
Rockush420: folds 
Glide Or: calls $0.50
1nyyfan: calls $0.50
*** FLOP *** [5c Ts 3d]
1nyyfan: checks 
JMAC60: bets $0.50
Glide Or: calls $0.50
1nyyfan: folds 
*** TURN *** [5c Ts 3d] [5s]
JMAC60: bets $1
Haek82 said, "what?"
Glide Or: calls $1
*** RIVER *** [5c Ts 3d 5s] [6c]
JMAC60: bets $1
Glide Or: folds 
JMAC60 collected $6.20 from pot
JMAC60: doesn't show hand 
*** SUMMARY ***
Total pot $6.50 | Rake $0.30 
Board [5c Ts 3d 5s 6c]
Seat 1: JMAC60 (big blind) collected ($6.20)
Seat 2: deepspace68 folded before Flop (didn't bet)
Seat 3: Rockush420 folded before Flop
Seat 5: Glide Or folded on the River
Seat 6: TheoParrish folded before Flop (didn't bet)
Seat 7: lamb1142 folded before Flop (didn't bet)
Seat 8: 1,1,2,3,5 folded before Flop (didn't bet)
Seat 9: Haek82 (button) folded before Flop (didn't bet)
Seat 10: 1nyyfan (small blind) folded on the Flop



PokerStars Game #6807895981:  Hold'em Limit ($0.50/$1.00) - 2006/10/28 - 21:16:40 (ET)
Table 'Tanina' 10-max Seat #10 is the button
Seat 1: JMAC60 ($25.90 in chips) 
Seat 2: deepspace68 ($34.75 in chips) 
Seat 3: Rockush420 ($23.75 in chips) 
Seat 5: Glide Or ($13.55 in chips) 
Seat 6: TheoParrish ($18.45 in chips) 
Seat 7: lamb1142 ($22.90 in chips) 
Seat 8: 1,1,2,3,5 ($16.40 in chips) 
Seat 9: Haek82 ($31.80 in chips) 
Seat 10: 1nyyfan ($24.95 in chips) 
JMAC60: posts small blind $0.25
deepspace68: posts big blind $0.50
*** HOLE CARDS ***
Dealt to 1,1,2,3,5 [7s 2h]
Rockush420: calls $0.50
Glide Or: folds 
TheoParrish: folds 
lamb1142: calls $0.50
1,1,2,3,5: folds 
Haek82: folds 
1nyyfan: folds 
JMAC60: folds 
Thumbber joins the table at seat #4 
deepspace68: checks 
*** FLOP *** [8h Td 8d]
deepspace68: checks 
1nyyfan said, "not you, the dumb shy that called all the way with nothing"
Rockush420: checks 
lamb1142: bets $0.50
deepspace68: folds 
Rockush420: calls $0.50
*** TURN *** [8h Td 8d] [Th]
Rockush420: checks 
lamb1142: bets $1
Rockush420: calls $1
*** RIVER *** [8h Td 8d Th] [2c]
Rockush420: checks 
lamb1142: bets $1
Rockush420: folds 
lamb1142 collected $4.55 from pot
*** SUMMARY ***
Total pot $4.75 | Rake $0.20 
Board [8h Td 8d Th 2c]
Seat 1: JMAC60 (small blind) folded before Flop
Seat 2: deepspace68 (big blind) folded on the Flop
Seat 3: Rockush420 folded on the River
Seat 5: Glide Or folded before Flop (didn't bet)
Seat 6: TheoParrish folded before Flop (didn't bet)
Seat 7: lamb1142 collected ($4.55)
Seat 8: 1,1,2,3,5 folded before Flop (didn't bet)
Seat 9: Haek82 folded before Flop (didn't bet)
Seat 10: 1nyyfan (button) folded before Flop (didn't bet)



PokerStars Game #6807913434:  Hold'em Limit ($0.50/$1.00) - 2006/10/28 - 21:18:06 (ET)
Table 'Tanina' 10-max Seat #1 is the button
Seat 1: JMAC60 ($25.65 in chips) 
Seat 2: deepspace68 ($34.25 in chips) 
Seat 3: Rockush420 ($21.75 in chips) 
Seat 5: Glide Or ($13.55 in chips) 
Seat 6: TheoParrish ($18.45 in chips) 
Seat 7: lamb1142 ($25.45 in chips) 
Seat 8: 1,1,2,3,5 ($16.40 in chips) 
Seat 9: Haek82 ($31.80 in chips) 
Seat 10: 1nyyfan ($24.95 in chips) 
deepspace68: posts small blind $0.25
Rockush420: posts big blind $0.50
Thumbber: sits out 
*** HOLE CARDS ***
Dealt to 1,1,2,3,5 [2d 7s]
Glide Or: folds 
TheoParrish: folds 
lamb1142: folds 
1,1,2,3,5: folds 
Haek82: calls $0.50
1nyyfan: calls $0.50
JMAC60: folds 
deepspace68: calls $0.25
Rockush420: checks 
*** FLOP *** [3c 3d 4h]
deepspace68: checks 
Rockush420: checks 
Haek82: checks 
1nyyfan: bets $0.50
deepspace68: folds 
Rockush420: folds 
Haek82: folds 
1nyyfan collected $1.90 from pot
*** SUMMARY ***
Total pot $2 | Rake $0.10 
Board [3c 3d 4h]
Seat 1: JMAC60 (button) folded before Flop (didn't bet)
Seat 2: deepspace68 (small blind) folded on the Flop
Seat 3: Rockush420 (big blind) folded on the Flop
Seat 5: Glide Or folded before Flop (didn't bet)
Seat 6: TheoParrish folded before Flop (didn't bet)
Seat 7: lamb1142 folded before Flop (didn't bet)
Seat 8: 1,1,2,3,5 folded before Flop (didn't bet)
Seat 9: Haek82 folded on the Flop
Seat 10: 1nyyfan collected ($1.90)



PokerStars Game #6807921613:  Hold'em Limit ($0.50/$1.00) - 2006/10/28 - 21:18:45 (ET)
Table 'Tanina' 10-max Seat #2 is the button
Seat 1: JMAC60 ($25.65 in chips) 
Seat 2: deepspace68 ($33.75 in chips) 
Seat 3: Rockush420 ($21.25 in chips) 
Seat 4: Thumbber ($20 in chips) 
Seat 5: Glide Or ($13.55 in chips) 
Seat 6: TheoParrish ($18.45 in chips) 
Seat 7: lamb1142 ($25.45 in chips) 
Seat 8: 1,1,2,3,5 ($16.40 in chips) 
Seat 9: Haek82 ($31.30 in chips) 
Seat 10: 1nyyfan ($26.35 in chips) 
Rockush420: posts small blind $0.25
Thumbber: posts big blind $0.50
*** HOLE CARDS ***
Dealt to 1,1,2,3,5 [Tc Ks]
Glide Or: folds 
TheoParrish: folds 
lamb1142: folds 
1,1,2,3,5: folds 
Haek82: folds 
1nyyfan: calls $0.50
JMAC60: folds 
deepspace68: folds 
Rockush420: folds 
Thumbber: checks 
*** FLOP *** [Jc 3d 3h]
Thumbber: checks 
1nyyfan: checks 
*** TURN *** [Jc 3d 3h] [9c]
Thumbber: bets $1
1nyyfan: folds 
Thumbber collected $1.20 from pot
Thumbber: doesn't show hand 
*** SUMMARY ***
Total pot $1.25 | Rake $0.05 
Board [Jc 3d 3h 9c]
Seat 1: JMAC60 folded before Flop (didn't bet)
Seat 2: deepspace68 (button) folded before Flop (didn't bet)
Seat 3: Rockush420 (small blind) folded before Flop
Seat 4: Thumbber (big blind) collected ($1.20)
Seat 5: Glide Or folded before Flop (didn't bet)
Seat 6: TheoParrish folded before Flop (didn't bet)
Seat 7: lamb1142 folded before Flop (didn't bet)
Seat 8: 1,1,2,3,5 folded before Flop (didn't bet)
Seat 9: Haek82 folded before Flop (didn't bet)
Seat 10: 1nyyfan folded on the Turn



PokerStars Game #6807928159:  Hold'em Limit ($0.50/$1.00) - 2006/10/28 - 21:19:19 (ET)
Table 'Tanina' 10-max Seat #3 is the button
Seat 1: JMAC60 ($25.65 in chips) 
Seat 2: deepspace68 ($33.75 in chips) 
Seat 3: Rockush420 ($21 in chips) 
Seat 4: Thumbber ($20.70 in chips) 
Seat 5: Glide Or ($13.55 in chips) 
Seat 6: TheoParrish ($18.45 in chips) 
Seat 7: lamb1142 ($25.45 in chips) 
Seat 8: 1,1,2,3,5 ($16.40 in chips) 
Seat 9: Haek82 ($31.30 in chips) 
Seat 10: 1nyyfan ($25.85 in chips) 
Thumbber: posts small blind $0.25
Glide Or: posts big blind $0.50
*** HOLE CARDS ***
Dealt to 1,1,2,3,5 [Ad 6c]
TheoParrish: folds 
lamb1142: folds 
1,1,2,3,5: folds 
Haek82: folds 
1nyyfan: calls $0.50
JMAC60: calls $0.50
deepspace68: folds 
Rockush420 has timed out
Rockush420: folds 
Rockush420 is sitting out
Thumbber: calls $0.25
Glide Or: checks 
*** FLOP *** [2d 6h 8c]
Thumbber: checks 
Glide Or: checks 
1nyyfan: checks 
JMAC60: checks 
*** TURN *** [2d 6h 8c] [Js]
Rockush420 has returned
Thumbber: checks 
Glide Or: checks 
1nyyfan: bets $1
JMAC60: raises $1 to $2
Thumbber: folds 
Glide Or: folds 
1nyyfan: calls $1
*** RIVER *** [2d 6h 8c Js] [4s]
1nyyfan: checks 
JMAC60: bets $1
1nyyfan: calls $1
*** SHOW DOWN ***
JMAC60: shows [Ks Jd] (a pair of Jacks)
1nyyfan: mucks hand 
JMAC60 collected $7.65 from pot
*** SUMMARY ***
Total pot $8 | Rake $0.35 
Board [2d 6h 8c Js 4s]
Seat 1: JMAC60 showed [Ks Jd] and won ($7.65) with a pair of Jacks
Seat 2: deepspace68 folded before Flop (didn't bet)
Seat 3: Rockush420 (button) folded before Flop (didn't bet)
Seat 4: Thumbber (small blind) folded on the Turn
Seat 5: Glide Or (big blind) folded on the Turn
Seat 6: TheoParrish folded before Flop (didn't bet)
Seat 7: lamb1142 folded before Flop (didn't bet)
Seat 8: 1,1,2,3,5 folded before Flop (didn't bet)
Seat 9: Haek82 folded before Flop (didn't bet)
Seat 10: 1nyyfan mucked [Tc Jc]



PokerStars Game #6807940956:  Hold'em Limit ($0.50/$1.00) - 2006/10/28 - 21:20:22 (ET)
Table 'Tanina' 10-max Seat #4 is the button
Seat 1: JMAC60 ($29.80 in chips) 
Seat 2: deepspace68 ($33.75 in chips) 
Seat 3: Rockush420 ($21 in chips) 
Seat 4: Thumbber ($20.20 in chips) 
Seat 5: Glide Or ($13.05 in chips) 
Seat 6: TheoParrish ($18.45 in chips) 
Seat 7: lamb1142 ($25.45 in chips) 
Seat 8: 1,1,2,3,5 ($16.40 in chips) 
Seat 9: Haek82 ($31.30 in chips) 
Seat 10: 1nyyfan ($22.35 in chips) 
Glide Or: posts small blind $0.25
TheoParrish: posts big blind $0.50
*** HOLE CARDS ***
Dealt to 1,1,2,3,5 [Ts 8s]
lamb1142: calls $0.50
1,1,2,3,5: folds 
Haek82: raises $0.50 to $1
1nyyfan: calls $1
JMAC60: folds 
deepspace68: folds 
Rockush420: folds 
Thumbber: calls $1
Glide Or: calls $0.75
TheoParrish: folds 
lamb1142: calls $0.50
*** FLOP *** [Jh 9h 6d]
Glide Or: checks 
lamb1142: checks 
Haek82: bets $0.50
1nyyfan: raises $0.50 to $1
Thumbber: folds 
Glide Or: calls $1
lamb1142: folds 
Haek82: calls $0.50
*** TURN *** [Jh 9h 6d] [Js]
Glide Or: checks 
Haek82: checks 
1nyyfan: bets $1
Glide Or: calls $1
Haek82: calls $1
*** RIVER *** [Jh 9h 6d Js] [7d]
Glide Or: checks 
Haek82: checks 
1nyyfan: bets $1
Glide Or: folds 
Haek82: calls $1
*** SHOW DOWN ***
1nyyfan: shows [6s 6c] (a full house, Sixes full of Jacks)
Haek82: shows [Kd Jd] (three of a kind, Jacks)
1nyyfan collected $13 from pot
*** SUMMARY ***
Total pot $13.50 | Rake $0.50 
Board [Jh 9h 6d Js 7d]
Seat 1: JMAC60 folded before Flop (didn't bet)
Seat 2: deepspace68 folded before Flop (didn't bet)
Seat 3: Rockush420 folded before Flop (didn't bet)
Seat 4: Thumbber (button) folded on the Flop
Seat 5: Glide Or (small blind) folded on the River
Seat 6: TheoParrish (big blind) folded before Flop
Seat 7: lamb1142 folded on the Flop
Seat 8: 1,1,2,3,5 folded before Flop (didn't bet)
Seat 9: Haek82 showed [Kd Jd] and lost with three of a kind, Jacks
Seat 10: 1nyyfan showed [6s 6c] and won ($13) with a full house, Sixes full of Jacks



PokerStars Game #6807953874:  Hold'em Limit ($0.50/$1.00) - 2006/10/28 - 21:21:27 (ET)
Table 'Tanina' 10-max Seat #5 is the button
Seat 1: JMAC60 ($29.80 in chips) 
Seat 2: deepspace68 ($33.75 in chips) 
Seat 3: Rockush420 ($21 in chips) 
Seat 4: Thumbber ($19.20 in chips) 
Seat 5: Glide Or ($10.05 in chips) 
Seat 6: TheoParrish ($17.95 in chips) 
Seat 7: lamb1142 ($24.45 in chips) 
Seat 8: 1,1,2,3,5 ($16.40 in chips) 
Seat 9: Haek82 ($27.30 in chips) 
Seat 10: 1nyyfan ($31.35 in chips) 
TheoParrish: posts small blind $0.25
lamb1142: posts big blind $0.50
*** HOLE CARDS ***
Dealt to 1,1,2,3,5 [5d 4s]
1,1,2,3,5: folds 
Haek82: raises $0.50 to $1
1nyyfan: folds 
JMAC60: folds 
deepspace68: folds 
Rockush420: folds 
Thumbber: folds 
Glide Or: folds 
TheoParrish: calls $0.75
lamb1142: calls $0.50
*** FLOP *** [9d 7s Tc]
TheoParrish: checks 
lamb1142: checks 
Haek82: bets $0.50
TheoParrish: folds 
lamb1142: calls $0.50
*** TURN *** [9d 7s Tc] [9c]
lamb1142: checks 
Haek82: bets $1
lamb1142: calls $1
*** RIVER *** [9d 7s Tc 9c] [3c]
lamb1142: checks 
Haek82: bets $1
lamb1142: calls $1
*** SHOW DOWN ***
Haek82: shows [7c 5c] (a flush, Ten high)
lamb1142: mucks hand 
Haek82 collected $7.65 from pot
*** SUMMARY ***
Total pot $8 | Rake $0.35 
Board [9d 7s Tc 9c 3c]
Seat 1: JMAC60 folded before Flop (didn't bet)
Seat 2: deepspace68 folded before Flop (didn't bet)
Seat 3: Rockush420 folded before Flop (didn't bet)
Seat 4: Thumbber folded before Flop (didn't bet)
Seat 5: Glide Or (button) folded before Flop (didn't bet)
Seat 6: TheoParrish (small blind) folded on the Flop
Seat 7: lamb1142 (big blind) mucked [Ks Jc]
Seat 8: 1,1,2,3,5 folded before Flop (didn't bet)
Seat 9: Haek82 showed [7c 5c] and won ($7.65) with a flush, Ten high
Seat 10: 1nyyfan folded before Flop (didn't bet)



PokerStars Game #6807965828:  Hold'em Limit ($0.50/$1.00) - 2006/10/28 - 21:22:26 (ET)
Table 'Tanina' 10-max Seat #6 is the button
Seat 1: JMAC60 ($29.80 in chips) 
Seat 2: deepspace68 ($33.75 in chips) 
Seat 3: Rockush420 ($21 in chips) 
Seat 4: Thumbber ($19.20 in chips) 
Seat 5: Glide Or ($10.05 in chips) 
Seat 6: TheoParrish ($16.95 in chips) 
Seat 7: lamb1142 ($20.95 in chips) 
Seat 8: 1,1,2,3,5 ($16.40 in chips) 
Seat 9: Haek82 ($31.45 in chips) 
Seat 10: 1nyyfan ($31.35 in chips) 
lamb1142: posts small blind $0.25
1,1,2,3,5: posts big blind $0.50
*** HOLE CARDS ***
Dealt to 1,1,2,3,5 [8c 9s]
Haek82: folds 
1nyyfan: folds 
JMAC60: folds 
deepspace68: folds 
Rockush420: folds 
Thumbber: calls $0.50
Glide Or: calls $0.50
TheoParrish: folds 
lamb1142: calls $0.25
1,1,2,3,5: checks 
*** FLOP *** [Js Tc 7c]
lamb1142: checks 
1,1,2,3,5: bets $0.50
Thumbber: calls $0.50
Glide Or: calls $0.50
lamb1142: folds 
*** TURN *** [Js Tc 7c] [4h]
1,1,2,3,5: bets $1
Thumbber: folds 
Glide Or: calls $1
*** RIVER *** [Js Tc 7c 4h] [2s]
1,1,2,3,5: bets $1
Glide Or: calls $1
*** SHOW DOWN ***
1,1,2,3,5: shows [8c 9s] (a straight, Seven to Jack)
Glide Or: shows [Th Kd] (a pair of Tens)
1,1,2,3,5 collected $7.15 from pot
*** SUMMARY ***
Total pot $7.50 | Rake $0.35 
Board [Js Tc 7c 4h 2s]
Seat 1: JMAC60 folded before Flop (didn't bet)
Seat 2: deepspace68 folded before Flop (didn't bet)
Seat 3: Rockush420 folded before Flop (didn't bet)
Seat 4: Thumbber folded on the Turn
Seat 5: Glide Or showed [Th Kd] and lost with a pair of Tens
Seat 6: TheoParrish (button) folded before Flop (didn't bet)
Seat 7: lamb1142 (small blind) folded on the Flop
Seat 8: 1,1,2,3,5 (big blind) showed [8c 9s] and won ($7.15) with a straight, Seven to Jack
Seat 9: Haek82 folded before Flop (didn't bet)
Seat 10: 1nyyfan folded before Flop (didn't bet)



PokerStars Game #6807975170:  Hold'em Limit ($0.50/$1.00) - 2006/10/28 - 21:23:10 (ET)
Table 'Tanina' 10-max Seat #7 is the button
Seat 1: JMAC60 ($29.80 in chips) 
Seat 2: deepspace68 ($33.75 in chips) 
Seat 3: Rockush420 ($21 in chips) 
Seat 4: Thumbber ($18.20 in chips) 
Seat 5: Glide Or ($7.05 in chips) 
Seat 6: TheoParrish ($16.95 in chips) 
Seat 7: lamb1142 ($20.45 in chips) 
Seat 8: 1,1,2,3,5 ($20.55 in chips) 
Seat 9: Haek82 ($31.45 in chips) 
Seat 10: 1nyyfan ($31.35 in chips) 
1,1,2,3,5: posts small blind $0.25
Haek82: posts big blind $0.50
*** HOLE CARDS ***
Dealt to 1,1,2,3,5 [2s Jc]
1nyyfan: calls $0.50
JMAC60: folds 
deepspace68: raises $0.50 to $1
Rockush420: calls $1
Thumbber: calls $1
Glide Or: folds 
TheoParrish: folds 
lamb1142: calls $1
1,1,2,3,5: folds 
Haek82: calls $0.50
1nyyfan: calls $0.50
*** FLOP *** [8h 6c 2h]
Haek82: checks 
1nyyfan: checks 
deepspace68: bets $0.50
Rockush420: folds 
Thumbber: folds 
lamb1142: calls $0.50
Haek82: calls $0.50
1nyyfan: folds 
*** TURN *** [8h 6c 2h] [9s]
Haek82: checks 
deepspace68: bets $1
lamb1142: calls $1
Haek82: calls $1
*** RIVER *** [8h 6c 2h 9s] [Kd]
Haek82: checks 
deepspace68: bets $1
lamb1142: folds 
Haek82: calls $1
*** SHOW DOWN ***
deepspace68: shows [Ah Ks] (a pair of Kings)
Haek82: mucks hand 
deepspace68 collected $12.25 from pot
*** SUMMARY ***
Total pot $12.75 | Rake $0.50 
Board [8h 6c 2h 9s Kd]
Seat 1: JMAC60 folded before Flop (didn't bet)
Seat 2: deepspace68 showed [Ah Ks] and won ($12.25) with a pair of Kings
Seat 3: Rockush420 folded on the Flop
Seat 4: Thumbber folded on the Flop
Seat 5: Glide Or folded before Flop (didn't bet)
Seat 6: TheoParrish folded before Flop (didn't bet)
Seat 7: lamb1142 (button) folded on the River
Seat 8: 1,1,2,3,5 (small blind) folded before Flop
Seat 9: Haek82 (big blind) mucked [9h Th]
Seat 10: 1nyyfan folded on the Flop



PokerStars Game #6807988355:  Hold'em Limit ($0.50/$1.00) - 2006/10/28 - 21:24:14 (ET)
Table 'Tanina' 10-max Seat #8 is the button
Seat 1: JMAC60 ($29.80 in chips) 
Seat 2: deepspace68 ($42.50 in chips) 
Seat 3: Rockush420 ($20 in chips) 
Seat 4: Thumbber ($17.20 in chips) 
Seat 5: Glide Or ($7.05 in chips) 
Seat 6: TheoParrish ($16.95 in chips) 
Seat 7: lamb1142 ($17.95 in chips) 
Seat 8: 1,1,2,3,5 ($20.30 in chips) 
Seat 9: Haek82 ($27.95 in chips) 
Seat 10: 1nyyfan ($30.35 in chips) 
Haek82: posts small blind $0.25
1nyyfan: posts big blind $0.50
*** HOLE CARDS ***
Dealt to 1,1,2,3,5 [Ts Kd]
JMAC60: folds 
deepspace68: folds 
Rockush420: folds 
Thumbber: folds 
Glide Or: calls $0.50
TheoParrish: folds 
lamb1142: raises $0.50 to $1
1,1,2,3,5: folds 
Haek82: folds 
1nyyfan: calls $0.50
Glide Or: calls $0.50
*** FLOP *** [Js Qd Jd]
1nyyfan: checks 
Glide Or: checks 
lamb1142: bets $0.50
1nyyfan: calls $0.50
Glide Or: calls $0.50
*** TURN *** [Js Qd Jd] [4h]
1nyyfan: checks 
Glide Or: checks 
lamb1142: bets $1
1nyyfan: calls $1
Glide Or: folds 
*** RIVER *** [Js Qd Jd 4h] [3c]
1nyyfan: checks 
lamb1142: checks 
*** SHOW DOWN ***
1nyyfan: shows [Qs 9s] (two pair, Queens and Jacks)
lamb1142: mucks hand 
1nyyfan collected $6.45 from pot
*** SUMMARY ***
Total pot $6.75 | Rake $0.30 
Board [Js Qd Jd 4h 3c]
Seat 1: JMAC60 folded before Flop (didn't bet)
Seat 2: deepspace68 folded before Flop (didn't bet)
Seat 3: Rockush420 folded before Flop (didn't bet)
Seat 4: Thumbber folded before Flop (didn't bet)
Seat 5: Glide Or folded on the Turn
Seat 6: TheoParrish folded before Flop (didn't bet)
Seat 7: lamb1142 mucked [Kh Ah]
Seat 8: 1,1,2,3,5 (button) folded before Flop (didn't bet)
Seat 9: Haek82 (small blind) folded before Flop
Seat 10: 1nyyfan (big blind) showed [Qs 9s] and won ($6.45) with two pair, Queens and Jacks



PokerStars Game #6807997172:  Hold'em Limit ($0.50/$1.00) - 2006/10/28 - 21:24:57 (ET)
Table 'Tanina' 10-max Seat #9 is the button
Seat 1: JMAC60 ($29.80 in chips) 
Seat 2: deepspace68 ($42.50 in chips) 
Seat 3: Rockush420 ($20 in chips) 
Seat 4: Thumbber ($17.20 in chips) 
Seat 5: Glide Or ($5.55 in chips) 
Seat 6: TheoParrish ($16.95 in chips) 
Seat 7: lamb1142 ($15.45 in chips) 
Seat 8: 1,1,2,3,5 ($20.30 in chips) 
Seat 9: Haek82 ($27.70 in chips) 
Seat 10: 1nyyfan ($34.30 in chips) 
1nyyfan: posts small blind $0.25
JMAC60: posts big blind $0.50
*** HOLE CARDS ***
Dealt to 1,1,2,3,5 [2h Kd]
deepspace68: folds 
Rockush420: folds 
Thumbber: calls $0.50
Glide Or: calls $0.50
TheoParrish: folds 
lamb1142: folds 
1,1,2,3,5: folds 
Haek82: folds 
1nyyfan: calls $0.25
JMAC60: checks 
*** FLOP *** [Qd 9s Ac]
1nyyfan: checks 
JMAC60: checks 
Thumbber: bets $0.50
Glide Or: folds 
1nyyfan: calls $0.50
JMAC60: folds 
*** TURN *** [Qd 9s Ac] [Jc]
1nyyfan: checks 
Thumbber: checks 
*** RIVER *** [Qd 9s Ac Jc] [3h]
1nyyfan: checks 
Thumbber: checks 
*** SHOW DOWN ***
1nyyfan: shows [Js Td] (a pair of Jacks)
Thumbber: shows [5c Ah] (a pair of Aces)
Thumbber collected $2.90 from pot
*** SUMMARY ***
Total pot $3 | Rake $0.10 
Board [Qd 9s Ac Jc 3h]
Seat 1: JMAC60 (big blind) folded on the Flop
Seat 2: deepspace68 folded before Flop (didn't bet)
Seat 3: Rockush420 folded before Flop (didn't bet)
Seat 4: Thumbber showed [5c Ah] and won ($2.90) with a pair of Aces
Seat 5: Glide Or folded on the Flop
Seat 6: TheoParrish folded before Flop (didn't bet)
Seat 7: lamb1142 folded before Flop (didn't bet)
Seat 8: 1,1,2,3,5 folded before Flop (didn't bet)
Seat 9: Haek82 (button) folded before Flop (didn't bet)
Seat 10: 1nyyfan (small blind) showed [Js Td] and lost with a pair of Jacks



PokerStars Game #6808004070:  Hold'em Limit ($0.50/$1.00) - 2006/10/28 - 21:25:32 (ET)
Table 'Tanina' 10-max Seat #10 is the button
Seat 1: JMAC60 ($29.30 in chips) 
Seat 2: deepspace68 ($42.50 in chips) 
Seat 3: Rockush420 ($20 in chips) 
Seat 4: Thumbber ($19.10 in chips) 
Seat 5: Glide Or ($5.05 in chips) 
Seat 6: TheoParrish ($16.95 in chips) 
Seat 7: lamb1142 ($15.45 in chips) 
Seat 8: 1,1,2,3,5 ($20.30 in chips) 
Seat 9: Haek82 ($27.70 in chips) 
Seat 10: 1nyyfan ($33.30 in chips) 
JMAC60: posts small blind $0.25
deepspace68: posts big blind $0.50
*** HOLE CARDS ***
Dealt to 1,1,2,3,5 [6s 5d]
Rockush420: folds 
Thumbber: folds 
Glide Or: calls $0.50
TheoParrish: folds 
lamb1142: folds 
1,1,2,3,5: folds 
Haek82: folds 
1nyyfan: folds 
JMAC60: raises $0.50 to $1
deepspace68: folds 
Glide Or: calls $0.50
*** FLOP *** [6h 8c Jh]
JMAC60: bets $0.50
Glide Or: folds 
JMAC60 collected $2.40 from pot
JMAC60: doesn't show hand 
*** SUMMARY ***
Total pot $2.50 | Rake $0.10 
Board [6h 8c Jh]
Seat 1: JMAC60 (small blind) collected ($2.40)
Seat 2: deepspace68 (big blind) folded before Flop
Seat 3: Rockush420 folded before Flop (didn't bet)
Seat 4: Thumbber folded before Flop (didn't bet)
Seat 5: Glide Or folded on the Flop
Seat 6: TheoParrish folded before Flop (didn't bet)
Seat 7: lamb1142 folded before Flop (didn't bet)
Seat 8: 1,1,2,3,5 folded before Flop (didn't bet)
Seat 9: Haek82 folded before Flop (didn't bet)
Seat 10: 1nyyfan (button) folded before Flop (didn't bet)



PokerStars Game #6808011128:  Hold'em Limit ($0.50/$1.00) - 2006/10/28 - 21:26:05 (ET)
Table 'Tanina' 10-max Seat #1 is the button
Seat 1: JMAC60 ($30.70 in chips) 
Seat 2: deepspace68 ($42 in chips) 
Seat 3: Rockush420 ($20 in chips) 
Seat 4: Thumbber ($19.10 in chips) 
Seat 5: Glide Or ($4.05 in chips) 
Seat 6: TheoParrish ($16.95 in chips) 
Seat 7: lamb1142 ($15.45 in chips) 
Seat 8: 1,1,2,3,5 ($20.30 in chips) 
Seat 9: Haek82 ($27.70 in chips) 
Seat 10: 1nyyfan ($33.30 in chips) 
deepspace68: posts small blind $0.25
Rockush420: posts big blind $0.50
*** HOLE CARDS ***
Dealt to 1,1,2,3,5 [9s Qs]
Thumbber: calls $0.50
Glide Or: calls $0.50
TheoParrish: folds 
lamb1142: calls $0.50
1,1,2,3,5: folds 
Haek82: folds 
1nyyfan: folds 
JMAC60: calls $0.50
deepspace68: calls $0.25
Rockush420: checks 
*** FLOP *** [4d 6d Ts]
deepspace68: checks 
Rockush420: checks 
Thumbber: checks 
Glide Or: checks 
lamb1142: checks 
JMAC60: checks 
*** TURN *** [4d 6d Ts] [As]
deepspace68: checks 
Rockush420: checks 
Thumbber: checks 
Glide Or: checks 
lamb1142: checks 
JMAC60: checks 
*** RIVER *** [4d 6d Ts As] [Td]
deepspace68: checks 
Rockush420: checks 
Thumbber: checks 
Glide Or: bets $1
lamb1142: folds 
JMAC60: folds 
deepspace68: calls $1
Rockush420: folds 
Thumbber: folds 
*** SHOW DOWN ***
Glide Or: shows [Ah Kh] (two pair, Aces and Tens)
deepspace68: mucks hand 
Glide Or collected $4.80 from pot
*** SUMMARY ***
Total pot $5 | Rake $0.20 
Board [4d 6d Ts As Td]
Seat 1: JMAC60 (button) folded on the River
Seat 2: deepspace68 (small blind) mucked [6h 3s]
Seat 3: Rockush420 (big blind) folded on the River
Seat 4: Thumbber folded on the River
Seat 5: Glide Or showed [Ah Kh] and won ($4.80) with two pair, Aces and Tens
Seat 6: TheoParrish folded before Flop (didn't bet)
Seat 7: lamb1142 folded on the River
Seat 8: 1,1,2,3,5 folded before Flop (didn't bet)
Seat 9: Haek82 folded before Flop (didn't bet)
Seat 10: 1nyyfan folded before Flop (didn't bet)



PokerStars Game #6808028331:  Hold'em Limit ($0.50/$1.00) - 2006/10/28 - 21:27:27 (ET)
Table 'Tanina' 10-max Seat #2 is the button
Seat 1: JMAC60 ($30.20 in chips) 
Seat 2: deepspace68 ($40.50 in chips) 
Seat 3: Rockush420 ($19.50 in chips) 
Seat 4: Thumbber ($18.60 in chips) 
Seat 5: Glide Or ($7.35 in chips) 
Seat 6: TheoParrish ($16.95 in chips) 
Seat 7: lamb1142 ($14.95 in chips) 
Seat 8: 1,1,2,3,5 ($20.30 in chips) 
Seat 9: Haek82 ($27.70 in chips) 
Seat 10: 1nyyfan ($33.30 in chips) 
Rockush420: posts small blind $0.25
Thumbber: posts big blind $0.50
*** HOLE CARDS ***
Dealt to 1,1,2,3,5 [9s Ah]
Glide Or: calls $0.50
TheoParrish: folds 
lamb1142: folds 
1,1,2,3,5: folds 
Haek82: folds 
1nyyfan: calls $0.50
JMAC60: folds 
deepspace68: folds 
Rockush420: calls $0.25
Thumbber: checks 
*** FLOP *** [2d 8d 2h]
Rockush420: checks 
Thumbber: bets $0.50
Glide Or: folds 
Glide Or leaves the table
1nyyfan: folds 
Rockush420: calls $0.50
*** TURN *** [2d 8d 2h] [Qc]
Rockush420: checks 
Thumbber: bets $1
Rockush420: calls $1
*** RIVER *** [2d 8d 2h Qc] [6c]
Rockush420: checks 
Thumbber: bets $1
Rockush420: folds 
Thumbber collected $4.80 from pot
Thumbber: doesn't show hand 
*** SUMMARY ***
Total pot $5 | Rake $0.20 
Board [2d 8d 2h Qc 6c]
Seat 1: JMAC60 folded before Flop (didn't bet)
Seat 2: deepspace68 (button) folded before Flop (didn't bet)
Seat 3: Rockush420 (small blind) folded on the River
Seat 4: Thumbber (big blind) collected ($4.80)
Seat 5: Glide Or folded on the Flop
Seat 6: TheoParrish folded before Flop (didn't bet)
Seat 7: lamb1142 folded before Flop (didn't bet)
Seat 8: 1,1,2,3,5 folded before Flop (didn't bet)
Seat 9: Haek82 folded before Flop (didn't bet)
Seat 10: 1nyyfan folded on the Flop



PokerStars Game #6808036574:  Hold'em Limit ($0.50/$1.00) - 2006/10/28 - 21:28:07 (ET)
Table 'Tanina' 10-max Seat #3 is the button
Seat 1: JMAC60 ($30.20 in chips) 
Seat 2: deepspace68 ($40.50 in chips) 
Seat 3: Rockush420 ($17.50 in chips) 
Seat 4: Thumbber ($21.40 in chips) 
Seat 6: TheoParrish ($16.95 in chips) 
Seat 7: lamb1142 ($14.95 in chips) 
Seat 8: 1,1,2,3,5 ($20.30 in chips) 
Seat 9: Haek82 ($27.70 in chips) 
Seat 10: 1nyyfan ($32.80 in chips) 
Thumbber: posts small blind $0.25
TheoParrish: posts big blind $0.50
*** HOLE CARDS ***
Dealt to 1,1,2,3,5 [Ac 3h]
lamb1142: folds 
1,1,2,3,5: folds 
Haek82: folds 
1nyyfan: calls $0.50
JMAC60: folds 
deepspace68: folds 
Rockush420: folds 
Thumbber: calls $0.25
TheoParrish: checks 
*** FLOP *** [4s Ks 6c]
Thumbber: checks 
TheoParrish: checks 
1nyyfan: checks 
*** TURN *** [4s Ks 6c] [Qs]
Thumbber: checks 
TheoParrish: checks 
1nyyfan: checks 
*** RIVER *** [4s Ks 6c Qs] [5s]
Thumbber: checks 
TheoParrish: checks 
1nyyfan: checks 
*** SHOW DOWN ***
Thumbber: shows [Ad 4d] (a pair of Fours)
TheoParrish: shows [8c 7s] (a flush, King high)
1nyyfan: mucks hand 
TheoParrish collected $1.45 from pot
*** SUMMARY ***
Total pot $1.50 | Rake $0.05 
Board [4s Ks 6c Qs 5s]
Seat 1: JMAC60 folded before Flop (didn't bet)
Seat 2: deepspace68 folded before Flop (didn't bet)
Seat 3: Rockush420 (button) folded before Flop (didn't bet)
Seat 4: Thumbber (small blind) showed [Ad 4d] and lost with a pair of Fours
Seat 6: TheoParrish (big blind) showed [8c 7s] and won ($1.45) with a flush, King high
Seat 7: lamb1142 folded before Flop (didn't bet)
Seat 8: 1,1,2,3,5 folded before Flop (didn't bet)
Seat 9: Haek82 folded before Flop (didn't bet)
Seat 10: 1nyyfan mucked [Qc Td]



PokerStars Game #6808045899:  Hold'em Limit ($0.50/$1.00) - 2006/10/28 - 21:28:52 (ET)
Table 'Tanina' 10-max Seat #4 is the button
Seat 1: JMAC60 ($30.20 in chips) 
Seat 2: deepspace68 ($40.50 in chips) 
Seat 3: Rockush420 ($17.50 in chips) 
Seat 4: Thumbber ($20.90 in chips) 
Seat 6: TheoParrish ($17.90 in chips) 
Seat 7: lamb1142 ($14.95 in chips) 
Seat 8: 1,1,2,3,5 ($20.30 in chips) 
Seat 9: Haek82 ($27.70 in chips) 
Seat 10: 1nyyfan ($32.30 in chips) 
TheoParrish: posts small blind $0.25
lamb1142: posts big blind $0.50
*** HOLE CARDS ***
Dealt to 1,1,2,3,5 [5d Th]
1,1,2,3,5: folds 
Haek82: folds 
1nyyfan: folds 
JMAC60: folds 
deepspace68: folds 
Rockush420: folds 
Thumbber: calls $0.50
w.t. spartan joins the table at seat #5 
TheoParrish: folds 
lamb1142: checks 
*** FLOP *** [Qh 3d Ks]
lamb1142: checks 
Thumbber: checks 
*** TURN *** [Qh 3d Ks] [Qc]
lamb1142: checks 
Thumbber: checks 
*** RIVER *** [Qh 3d Ks Qc] [9h]
lamb1142: bets $1
Thumbber: folds 
lamb1142 collected $1.20 from pot
*** SUMMARY ***
Total pot $1.25 | Rake $0.05 
Board [Qh 3d Ks Qc 9h]
Seat 1: JMAC60 folded before Flop (didn't bet)
Seat 2: deepspace68 folded before Flop (didn't bet)
Seat 3: Rockush420 folded before Flop (didn't bet)
Seat 4: Thumbber (button) folded on the River
Seat 6: TheoParrish (small blind) folded before Flop
Seat 7: lamb1142 (big blind) collected ($1.20)
Seat 8: 1,1,2,3,5 folded before Flop (didn't bet)
Seat 9: Haek82 folded before Flop (didn't bet)
Seat 10: 1nyyfan folded before Flop (didn't bet)



PokerStars Game #6808052372:  Hold'em Limit ($0.50/$1.00) - 2006/10/28 - 21:29:23 (ET)
Table 'Tanina' 10-max Seat #6 is the button
Seat 1: JMAC60 ($30.20 in chips) 
Seat 2: deepspace68 ($40.50 in chips) 
Seat 3: Rockush420 ($17.50 in chips) 
Seat 4: Thumbber ($20.40 in chips) 
Seat 5: w.t. spartan ($20 in chips) 
Seat 6: TheoParrish ($17.65 in chips) 
Seat 7: lamb1142 ($15.65 in chips) 
Seat 8: 1,1,2,3,5 ($20.30 in chips) 
Seat 9: Haek82 ($27.70 in chips) 
Seat 10: 1nyyfan ($32.30 in chips) 
lamb1142: posts small blind $0.25
1,1,2,3,5: posts big blind $0.50
w.t. spartan: posts big blind $0.50
*** HOLE CARDS ***
Dealt to 1,1,2,3,5 [8h 4d]
Haek82: folds 
1nyyfan: folds 
JMAC60: raises $0.50 to $1
deepspace68: folds 
Rockush420: folds 
Thumbber: folds 
w.t. spartan: calls $0.50
TheoParrish: folds 
lamb1142: folds 
1,1,2,3,5: folds 
*** FLOP *** [2s Ah 2d]
JMAC60: bets $0.50
w.t. spartan: folds 
JMAC60 collected $2.65 from pot
JMAC60: doesn't show hand 
*** SUMMARY ***
Total pot $2.75 | Rake $0.10 
Board [2s Ah 2d]
Seat 1: JMAC60 collected ($2.65)
Seat 2: deepspace68 folded before Flop (didn't bet)
Seat 3: Rockush420 folded before Flop (didn't bet)
Seat 4: Thumbber folded before Flop (didn't bet)
Seat 5: w.t. spartan folded on the Flop
Seat 6: TheoParrish (button) folded before Flop (didn't bet)
Seat 7: lamb1142 (small blind) folded before Flop
Seat 8: 1,1,2,3,5 (big blind) folded before Flop
Seat 9: Haek82 folded before Flop (didn't bet)
Seat 10: 1nyyfan folded before Flop (didn't bet)



PokerStars Game #6808057837:  Hold'em Limit ($0.50/$1.00) - 2006/10/28 - 21:29:49 (ET)
Table 'Tanina' 10-max Seat #7 is the button
Seat 1: JMAC60 ($31.85 in chips) 
Seat 2: deepspace68 ($40.50 in chips) 
Seat 3: Rockush420 ($17.50 in chips) 
Seat 4: Thumbber ($20.40 in chips) 
Seat 5: w.t. spartan ($19 in chips) 
Seat 6: TheoParrish ($17.65 in chips) 
Seat 7: lamb1142 ($15.40 in chips) 
Seat 8: 1,1,2,3,5 ($19.80 in chips) 
Seat 9: Haek82 ($27.70 in chips) 
Seat 10: 1nyyfan ($32.30 in chips) 
1,1,2,3,5: posts small blind $0.25
Haek82: posts big blind $0.50
*** HOLE CARDS ***
Dealt to 1,1,2,3,5 [2h 3d]
1nyyfan: folds 
JMAC60: folds 
deepspace68: folds 
Rockush420: folds 
Thumbber: calls $0.50
w.t. spartan: folds 
TheoParrish: calls $0.50
lamb1142: folds 
1,1,2,3,5: folds 
Haek82: checks 
*** FLOP *** [Ts As Ah]
Haek82: checks 
Thumbber: checks 
TheoParrish: bets $0.50
Haek82: folds 
Thumbber: calls $0.50
*** TURN *** [Ts As Ah] [3s]
Thumbber: checks 
TheoParrish: bets $1
Thumbber: raises $1 to $2
TheoParrish: calls $1
*** RIVER *** [Ts As Ah 3s] [4s]
Thumbber: checks 
TheoParrish: checks 
*** SHOW DOWN ***
Thumbber: shows [Js 8s] (a flush, Ace high)
TheoParrish: mucks hand 
Thumbber collected $6.45 from pot
*** SUMMARY ***
Total pot $6.75 | Rake $0.30 
Board [Ts As Ah 3s 4s]
Seat 1: JMAC60 folded before Flop (didn't bet)
Seat 2: deepspace68 folded before Flop (didn't bet)
Seat 3: Rockush420 folded before Flop (didn't bet)
Seat 4: Thumbber showed [Js 8s] and won ($6.45) with a flush, Ace high
Seat 5: w.t. spartan folded before Flop (didn't bet)
Seat 6: TheoParrish mucked [Ac 8c]
Seat 7: lamb1142 (button) folded before Flop (didn't bet)
Seat 8: 1,1,2,3,5 (small blind) folded before Flop
Seat 9: Haek82 (big blind) folded on the Flop
Seat 10: 1nyyfan folded before Flop (didn't bet)



PokerStars Game #6808068323:  Hold'em Limit ($0.50/$1.00) - 2006/10/28 - 21:30:40 (ET)
Table 'Tanina' 10-max Seat #8 is the button
Seat 1: JMAC60 ($31.85 in chips) 
Seat 2: deepspace68 ($40.50 in chips) 
Seat 3: Rockush420 ($17.50 in chips) 
Seat 4: Thumbber ($23.85 in chips) 
Seat 5: w.t. spartan ($19 in chips) 
Seat 6: TheoParrish ($14.65 in chips) 
Seat 7: lamb1142 ($15.40 in chips) 
Seat 8: 1,1,2,3,5 ($19.55 in chips) 
Seat 9: Haek82 ($27.20 in chips) 
Seat 10: 1nyyfan ($32.30 in chips) 
Haek82: posts small blind $0.25
1nyyfan: posts big blind $0.50
*** HOLE CARDS ***
Dealt to 1,1,2,3,5 [7d Js]
JMAC60: folds 
deepspace68: raises $0.50 to $1
Rockush420: folds 
Thumbber: folds 
w.t. spartan: folds 
TheoParrish: folds 
lamb1142: folds 
1,1,2,3,5: folds 
Haek82: folds 
1nyyfan: folds 
deepspace68 collected $1.25 from pot
*** SUMMARY ***
Total pot $1.25 | Rake $0 
Seat 1: JMAC60 folded before Flop (didn't bet)
Seat 2: deepspace68 collected ($1.25)
Seat 3: Rockush420 folded before Flop (didn't bet)
Seat 4: Thumbber folded before Flop (didn't bet)
Seat 5: w.t. spartan folded before Flop (didn't bet)
Seat 6: TheoParrish folded before Flop (didn't bet)
Seat 7: lamb1142 folded before Flop (didn't bet)
Seat 8: 1,1,2,3,5 (button) folded before Flop (didn't bet)
Seat 9: Haek82 (small blind) folded before Flop
Seat 10: 1nyyfan (big blind) folded before Flop



PokerStars Game #6808073206:  Hold'em Limit ($0.50/$1.00) - 2006/10/28 - 21:31:04 (ET)
Table 'Tanina' 10-max Seat #9 is the button
Seat 1: JMAC60 ($31.85 in chips) 
Seat 2: deepspace68 ($41.25 in chips) 
Seat 3: Rockush420 ($17.50 in chips) 
Seat 4: Thumbber ($23.85 in chips) 
Seat 5: w.t. spartan ($19 in chips) 
Seat 6: TheoParrish ($14.65 in chips) 
Seat 7: lamb1142 ($15.40 in chips) 
Seat 8: 1,1,2,3,5 ($19.55 in chips) 
Seat 9: Haek82 ($26.95 in chips) 
Seat 10: 1nyyfan ($31.80 in chips) 
1nyyfan: posts small blind $0.25
JMAC60: posts big blind $0.50
*** HOLE CARDS ***
Dealt to 1,1,2,3,5 [5s 7s]
deepspace68: folds 
Rockush420: folds 
Thumbber: calls $0.50
w.t. spartan: calls $0.50
TheoParrish: folds 
lamb1142: folds 
1,1,2,3,5: folds 
Haek82: folds 
1nyyfan: calls $0.25
JMAC60: checks 
*** FLOP *** [Kc Ad 2h]
1nyyfan: checks 
JMAC60: checks 
Thumbber: checks 
w.t. spartan: bets $0.50
1nyyfan: folds 
JMAC60: folds 
Thumbber: calls $0.50
*** TURN *** [Kc Ad 2h] [3s]
Thumbber: checks 
w.t. spartan: bets $1
Thumbber: raises $1 to $2
w.t. spartan: calls $1
*** RIVER *** [Kc Ad 2h 3s] [As]
Thumbber: bets $1
w.t. spartan: calls $1
*** SHOW DOWN ***
Thumbber: shows [4h 5h] (a straight, Ace to Five)
w.t. spartan: mucks hand 
Thumbber collected $8.60 from pot
*** SUMMARY ***
Total pot $9 | Rake $0.40 
Board [Kc Ad 2h 3s As]
Seat 1: JMAC60 (big blind) folded on the Flop
Seat 2: deepspace68 folded before Flop (didn't bet)
Seat 3: Rockush420 folded before Flop (didn't bet)
Seat 4: Thumbber showed [4h 5h] and won ($8.60) with a straight, Ace to Five
Seat 5: w.t. spartan mucked [Kh Js]
Seat 6: TheoParrish folded before Flop (didn't bet)
Seat 7: lamb1142 folded before Flop (didn't bet)
Seat 8: 1,1,2,3,5 folded before Flop (didn't bet)
Seat 9: Haek82 (button) folded before Flop (didn't bet)
Seat 10: 1nyyfan (small blind) folded on the Flop



PokerStars Game #6808083805:  Hold'em Limit ($0.50/$1.00) - 2006/10/28 - 21:31:56 (ET)
Table 'Tanina' 10-max Seat #10 is the button
Seat 1: JMAC60 ($31.35 in chips) 
Seat 2: deepspace68 ($41.25 in chips) 
Seat 3: Rockush420 ($17.50 in chips) 
Seat 4: Thumbber ($28.45 in chips) 
Seat 5: w.t. spartan ($15 in chips) 
Seat 6: TheoParrish ($14.65 in chips) 
Seat 7: lamb1142 ($15.40 in chips) 
Seat 8: 1,1,2,3,5 ($19.55 in chips) 
Seat 9: Haek82 ($26.95 in chips) 
Seat 10: 1nyyfan ($31.30 in chips) 
JMAC60: posts small blind $0.25
deepspace68: posts big blind $0.50
*** HOLE CARDS ***
Dealt to 1,1,2,3,5 [4d 3h]
Rockush420: folds 
Thumbber: calls $0.50
w.t. spartan: folds 
TheoParrish: folds 
Rockush420 is sitting out
lamb1142: calls $0.50
1,1,2,3,5: folds 
Haek82: folds 
1nyyfan: folds 
JMAC60: folds 
deepspace68: checks 
*** FLOP *** [2d 2s Th]
deepspace68: checks 
Thumbber: checks 
lamb1142: bets $0.50
deepspace68: folds 
Thumbber: folds 
lamb1142 collected $1.70 from pot
*** SUMMARY ***
Total pot $1.75 | Rake $0.05 
Board [2d 2s Th]
Seat 1: JMAC60 (small blind) folded before Flop
Seat 2: deepspace68 (big blind) folded on the Flop
Seat 3: Rockush420 folded before Flop (didn't bet)
Seat 4: Thumbber folded on the Flop
Seat 5: w.t. spartan folded before Flop (didn't bet)
Seat 6: TheoParrish folded before Flop (didn't bet)
Seat 7: lamb1142 collected ($1.70)
Seat 8: 1,1,2,3,5 folded before Flop (didn't bet)
Seat 9: Haek82 folded before Flop (didn't bet)
Seat 10: 1nyyfan (button) folded before Flop (didn't bet)



PokerStars Game #6808091124:  Hold'em Limit ($0.50/$1.00) - 2006/10/28 - 21:32:32 (ET)
Table 'Tanina' 10-max Seat #1 is the button
Seat 1: JMAC60 ($31.10 in chips) 
Seat 2: deepspace68 ($40.75 in chips) 
Seat 4: Thumbber ($27.95 in chips) 
Seat 5: w.t. spartan ($15 in chips) 
Seat 6: TheoParrish ($14.65 in chips) 
Seat 7: lamb1142 ($16.60 in chips) 
Seat 8: 1,1,2,3,5 ($19.55 in chips) 
Seat 9: Haek82 ($26.95 in chips) 
Seat 10: 1nyyfan ($31.30 in chips) 
deepspace68: posts small blind $0.25
Thumbber: posts big blind $0.50
*** HOLE CARDS ***
Dealt to 1,1,2,3,5 [Kd 5s]
Rockush420 leaves the table
w.t. spartan: folds 
TheoParrish: folds 
lamb1142: folds 
1,1,2,3,5: folds 
Haek82: folds 
1nyyfan: folds 
JMAC60: folds 
deepspace68: calls $0.25
Thumbber: checks 
*** FLOP *** [Jc Js 3c]
deepspace68: bets $0.50
wpcrso joins the table at seat #3 
Thumbber: folds 
deepspace68 collected $0.95 from pot
*** SUMMARY ***
Total pot $1 | Rake $0.05 
Board [Jc Js 3c]
Seat 1: JMAC60 (button) folded before Flop (didn't bet)
Seat 2: deepspace68 (small blind) collected ($0.95)
Seat 4: Thumbber (big blind) folded on the Flop
Seat 5: w.t. spartan folded before Flop (didn't bet)
Seat 6: TheoParrish folded before Flop (didn't bet)
Seat 7: lamb1142 folded before Flop (didn't bet)
Seat 8: 1,1,2,3,5 folded before Flop (didn't bet)
Seat 9: Haek82 folded before Flop (didn't bet)
Seat 10: 1nyyfan folded before Flop (didn't bet)



PokerStars Game #6808097392:  Hold'em Limit ($0.50/$1.00) - 2006/10/28 - 21:33:03 (ET)
Table 'Tanina' 10-max Seat #2 is the button
Seat 1: JMAC60 ($31.10 in chips) 
Seat 2: deepspace68 ($41.20 in chips) 
Seat 4: Thumbber ($27.45 in chips) 
Seat 5: w.t. spartan ($15 in chips) 
Seat 6: TheoParrish ($14.65 in chips) 
Seat 7: lamb1142 ($16.60 in chips) 
Seat 8: 1,1,2,3,5 ($19.55 in chips) 
Seat 9: Haek82 ($26.95 in chips) 
Seat 10: 1nyyfan ($31.30 in chips) 
wpcrso will be allowed to play after the button
Thumbber: posts small blind $0.25
w.t. spartan: posts big blind $0.50
*** HOLE CARDS ***
Dealt to 1,1,2,3,5 [Th 5s]
TheoParrish: calls $0.50
lamb1142: folds 
1,1,2,3,5: folds 
Haek82: calls $0.50
1nyyfan: folds 
JMAC60: raises $0.50 to $1
deepspace68: folds 
Thumbber: folds 
w.t. spartan: calls $0.50
TheoParrish: calls $0.50
Haek82: calls $0.50
*** FLOP *** [8d 3c 4h]
w.t. spartan: bets $0.50
TheoParrish: folds 
Haek82: folds 
JMAC60: calls $0.50
*** TURN *** [8d 3c 4h] [Qc]
w.t. spartan: checks 
JMAC60: bets $1
w.t. spartan: calls $1
*** RIVER *** [8d 3c 4h Qc] [3d]
w.t. spartan: checks 
JMAC60: bets $1
w.t. spartan: folds 
JMAC60 collected $6.90 from pot
JMAC60: doesn't show hand 
*** SUMMARY ***
Total pot $7.25 | Rake $0.35 
Board [8d 3c 4h Qc 3d]
Seat 1: JMAC60 collected ($6.90)
Seat 2: deepspace68 (button) folded before Flop (didn't bet)
Seat 4: Thumbber (small blind) folded before Flop
Seat 5: w.t. spartan (big blind) folded on the River
Seat 6: TheoParrish folded on the Flop
Seat 7: lamb1142 folded before Flop (didn't bet)
Seat 8: 1,1,2,3,5 folded before Flop (didn't bet)
Seat 9: Haek82 folded on the Flop
Seat 10: 1nyyfan folded before Flop (didn't bet)



PokerStars Game #6808106439:  Hold'em Limit ($0.50/$1.00) - 2006/10/28 - 21:33:48 (ET)
Table 'Tanina' 10-max Seat #4 is the button
Seat 1: JMAC60 ($35.50 in chips) 
Seat 2: deepspace68 ($41.20 in chips) 
Seat 3: wpcrso ($20 in chips) 
Seat 4: Thumbber ($27.20 in chips) 
Seat 5: w.t. spartan ($12.50 in chips) 
Seat 6: TheoParrish ($13.65 in chips) 
Seat 7: lamb1142 ($16.60 in chips) 
Seat 8: 1,1,2,3,5 ($19.55 in chips) 
Seat 9: Haek82 ($25.95 in chips) 
Seat 10: 1nyyfan ($31.30 in chips) 
w.t. spartan: posts small blind $0.25
TheoParrish: posts big blind $0.50
wpcrso: posts big blind $0.50
*** HOLE CARDS ***
Dealt to 1,1,2,3,5 [6h 6d]
lamb1142: folds 
1,1,2,3,5: calls $0.50
Haek82: folds 
1nyyfan: folds 
JMAC60: raises $0.50 to $1
deepspace68: folds 
wpcrso: folds 
Thumbber: calls $1
w.t. spartan: folds 
TheoParrish: calls $0.50
1,1,2,3,5: calls $0.50
*** FLOP *** [Qc 3d 2s]
TheoParrish: checks 
1,1,2,3,5: checks 
JMAC60: bets $0.50
Thumbber: folds 
TheoParrish: calls $0.50
1,1,2,3,5: folds 
*** TURN *** [Qc 3d 2s] [8d]
TheoParrish: checks 
JMAC60: checks 
*** RIVER *** [Qc 3d 2s 8d] [Ad]
TheoParrish: checks 
JMAC60: bets $1
TheoParrish: calls $1
*** SHOW DOWN ***
JMAC60: shows [As Js] (a pair of Aces)
TheoParrish: mucks hand 
JMAC60 collected $7.40 from pot
*** SUMMARY ***
Total pot $7.75 | Rake $0.35 
Board [Qc 3d 2s 8d Ad]
Seat 1: JMAC60 showed [As Js] and won ($7.40) with a pair of Aces
Seat 2: deepspace68 folded before Flop (didn't bet)
Seat 3: wpcrso folded before Flop
Seat 4: Thumbber (button) folded on the Flop
Seat 5: w.t. spartan (small blind) folded before Flop
Seat 6: TheoParrish (big blind) mucked [Ac Tc]
Seat 7: lamb1142 folded before Flop (didn't bet)
Seat 8: 1,1,2,3,5 folded on the Flop
Seat 9: Haek82 folded before Flop (didn't bet)
Seat 10: 1nyyfan folded before Flop (didn't bet)



PokerStars Game #6808116145:  Hold'em Limit ($0.50/$1.00) - 2006/10/28 - 21:34:36 (ET)
Table 'Tanina' 10-max Seat #5 is the button
Seat 1: JMAC60 ($40.40 in chips) 
Seat 2: deepspace68 ($41.20 in chips) 
Seat 3: wpcrso ($19.50 in chips) 
Seat 4: Thumbber ($26.20 in chips) 
Seat 5: w.t. spartan ($12.25 in chips) 
Seat 6: TheoParrish ($11.15 in chips) 
Seat 7: lamb1142 ($16.60 in chips) 
Seat 8: 1,1,2,3,5 ($18.55 in chips) 
Seat 9: Haek82 ($25.95 in chips) 
Seat 10: 1nyyfan ($31.30 in chips) 
TheoParrish: posts small blind $0.25
lamb1142: posts big blind $0.50
*** HOLE CARDS ***
Dealt to 1,1,2,3,5 [Qc Ac]
1,1,2,3,5: raises $0.50 to $1
Haek82: folds 
1nyyfan: folds 
JMAC60: folds 
deepspace68: folds 
wpcrso: folds 
Thumbber: folds 
w.t. spartan: folds 
TheoParrish: folds 
lamb1142: calls $0.50
*** FLOP *** [Ah 3h 9s]
lamb1142: checks 
1,1,2,3,5: bets $0.50
lamb1142: calls $0.50
*** TURN *** [Ah 3h 9s] [Kc]
lamb1142: checks 
1,1,2,3,5: bets $1
lamb1142: folds 
1,1,2,3,5 collected $3.10 from pot
1,1,2,3,5: doesn't show hand 
*** SUMMARY ***
Total pot $3.25 | Rake $0.15 
Board [Ah 3h 9s Kc]
Seat 1: JMAC60 folded before Flop (didn't bet)
Seat 2: deepspace68 folded before Flop (didn't bet)
Seat 3: wpcrso folded before Flop (didn't bet)
Seat 4: Thumbber folded before Flop (didn't bet)
Seat 5: w.t. spartan (button) folded before Flop (didn't bet)
Seat 6: TheoParrish (small blind) folded before Flop
Seat 7: lamb1142 (big blind) folded on the Turn
Seat 8: 1,1,2,3,5 collected ($3.10)
Seat 9: Haek82 folded before Flop (didn't bet)
Seat 10: 1nyyfan folded before Flop (didn't bet)



PokerStars Game #6808123762:  Hold'em Limit ($0.50/$1.00) - 2006/10/28 - 21:35:14 (ET)
Table 'Tanina' 10-max Seat #6 is the button
Seat 1: JMAC60 ($40.40 in chips) 
Seat 2: deepspace68 ($41.20 in chips) 
Seat 3: wpcrso ($19.50 in chips) 
Seat 4: Thumbber ($26.20 in chips) 
Seat 5: w.t. spartan ($12.25 in chips) 
Seat 6: TheoParrish ($10.90 in chips) 
Seat 7: lamb1142 ($15.10 in chips) 
Seat 8: 1,1,2,3,5 ($20.15 in chips) 
Seat 9: Haek82 ($25.95 in chips) 
Seat 10: 1nyyfan ($31.30 in chips) 
lamb1142: posts small blind $0.25
1,1,2,3,5: posts big blind $0.50
*** HOLE CARDS ***
Dealt to 1,1,2,3,5 [Kd 3h]
Haek82: folds 
1nyyfan: folds 
JMAC60: calls $0.50
deepspace68: folds 
wpcrso: folds 
Thumbber: calls $0.50
w.t. spartan: folds 
TheoParrish: folds 
lamb1142: folds 
1,1,2,3,5: checks 
*** FLOP *** [6c 2s 6s]
1,1,2,3,5: checks 
JMAC60: bets $0.50
Thumbber: raises $0.50 to $1
1,1,2,3,5: folds 
JMAC60: calls $0.50
*** TURN *** [6c 2s 6s] [4h]
JMAC60: checks 
Thumbber: bets $1
JMAC60: calls $1
*** RIVER *** [6c 2s 6s 4h] [Ts]
JMAC60: checks 
Thumbber: bets $1
JMAC60: raises $1 to $2
Thumbber: raises $1 to $3
JMAC60: calls $1
*** SHOW DOWN ***
Thumbber: shows [4c 4s] (a full house, Fours full of Sixes)
JMAC60: mucks hand 
Thumbber collected $11.25 from pot
*** SUMMARY ***
Total pot $11.75 | Rake $0.50 
Board [6c 2s 6s 4h Ts]
Seat 1: JMAC60 mucked [9s Js]
Seat 2: deepspace68 folded before Flop (didn't bet)
Seat 3: wpcrso folded before Flop (didn't bet)
Seat 4: Thumbber showed [4c 4s] and won ($11.25) with a full house, Fours full of Sixes
Seat 5: w.t. spartan folded before Flop (didn't bet)
Seat 6: TheoParrish (button) folded before Flop (didn't bet)
Seat 7: lamb1142 (small blind) folded before Flop
Seat 8: 1,1,2,3,5 (big blind) folded on the Flop
Seat 9: Haek82 folded before Flop (didn't bet)
Seat 10: 1nyyfan folded before Flop (didn't bet)



PokerStars Game #6808134410:  Hold'em Limit ($0.50/$1.00) - 2006/10/28 - 21:36:08 (ET)
Table 'Tanina' 10-max Seat #7 is the button
Seat 1: JMAC60 ($34.90 in chips) 
Seat 2: deepspace68 ($41.20 in chips) 
Seat 3: wpcrso ($19.50 in chips) 
Seat 4: Thumbber ($31.95 in chips) 
Seat 5: w.t. spartan ($12.25 in chips) 
Seat 6: TheoParrish ($10.90 in chips) 
Seat 7: lamb1142 ($14.85 in chips) 
Seat 8: 1,1,2,3,5 ($19.65 in chips) 
Seat 9: Haek82 ($25.95 in chips) 
Seat 10: 1nyyfan ($31.30 in chips) 
1,1,2,3,5: posts small blind $0.25
Haek82: posts big blind $0.50
*** HOLE CARDS ***
Dealt to 1,1,2,3,5 [8s Qh]
1nyyfan: folds 
JMAC60: folds 
deepspace68: folds 
wpcrso: folds 
Thumbber: calls $0.50
w.t. spartan: folds 
TheoParrish: folds 
lamb1142: folds 
1,1,2,3,5: calls $0.25
Haek82: checks 
*** FLOP *** [6h 9c 4d]
1,1,2,3,5: checks 
Haek82: bets $0.50
Thumbber: calls $0.50
1,1,2,3,5: folds 
*** TURN *** [6h 9c 4d] [4s]
Haek82: checks 
Thumbber: bets $1
Haek82: calls $1
*** RIVER *** [6h 9c 4d 4s] [9d]
Haek82: checks 
Thumbber: bets $1
Haek82: raises $1 to $2
Thumbber: raises $1 to $3
Haek82: raises $1 to $4
Betting is capped
Thumbber: calls $1
*** SHOW DOWN ***
Haek82: shows [9s 3c] (a full house, Nines full of Fours)
Thumbber: mucks hand 
Haek82 collected $12 from pot
*** SUMMARY ***
Total pot $12.50 | Rake $0.50 
Board [6h 9c 4d 4s 9d]
Seat 1: JMAC60 folded before Flop (didn't bet)
Seat 2: deepspace68 folded before Flop (didn't bet)
Seat 3: wpcrso folded before Flop (didn't bet)
Seat 4: Thumbber mucked [6c 6d]
Seat 5: w.t. spartan folded before Flop (didn't bet)
Seat 6: TheoParrish folded before Flop (didn't bet)
Seat 7: lamb1142 (button) folded before Flop (didn't bet)
Seat 8: 1,1,2,3,5 (small blind) folded on the Flop
Seat 9: Haek82 (big blind) showed [9s 3c] and won ($12) with a full house, Nines full of Fours
Seat 10: 1nyyfan folded before Flop (didn't bet)



PokerStars Game #6808143130:  Hold'em Limit ($0.50/$1.00) - 2006/10/28 - 21:36:52 (ET)
Table 'Tanina' 10-max Seat #8 is the button
Seat 1: JMAC60 ($34.90 in chips) 
Seat 2: deepspace68 ($41.20 in chips) 
Seat 3: wpcrso ($19.50 in chips) 
Seat 4: Thumbber ($25.95 in chips) 
Seat 5: w.t. spartan ($12.25 in chips) 
Seat 6: TheoParrish ($10.90 in chips) 
Seat 7: lamb1142 ($14.85 in chips) 
Seat 8: 1,1,2,3,5 ($19.15 in chips) 
Seat 9: Haek82 ($31.95 in chips) 
Seat 10: 1nyyfan ($31.30 in chips) 
Haek82: posts small blind $0.25
1nyyfan: posts big blind $0.50
*** HOLE CARDS ***
Dealt to 1,1,2,3,5 [5h 3s]
JMAC60: folds 
deepspace68: folds 
wpcrso: folds 
Thumbber: calls $0.50
w.t. spartan: folds 
TheoParrish: folds 
lamb1142: folds 
1,1,2,3,5: folds 
Haek82: calls $0.25
1nyyfan: checks 
*** FLOP *** [2c Kh 4s]
Haek82: checks 
1nyyfan: checks 
Thumbber: checks 
*** TURN *** [2c Kh 4s] [2h]
Haek82: checks 
1nyyfan: checks 
Thumbber: checks 
*** RIVER *** [2c Kh 4s 2h] [9c]
Haek82: checks 
1nyyfan: checks 
Thumbber: checks 
*** SHOW DOWN ***
Haek82: shows [Qs 5s] (a pair of Deuces)
1nyyfan: mucks hand 
Thumbber: mucks hand 
Haek82 collected $1.45 from pot
*** SUMMARY ***
Total pot $1.50 | Rake $0.05 
Board [2c Kh 4s 2h 9c]
Seat 1: JMAC60 folded before Flop (didn't bet)
Seat 2: deepspace68 folded before Flop (didn't bet)
Seat 3: wpcrso folded before Flop (didn't bet)
Seat 4: Thumbber mucked [Tc Js]
Seat 5: w.t. spartan folded before Flop (didn't bet)
Seat 6: TheoParrish folded before Flop (didn't bet)
Seat 7: lamb1142 folded before Flop (didn't bet)
Seat 8: 1,1,2,3,5 (button) folded before Flop (didn't bet)
Seat 9: Haek82 (small blind) showed [Qs 5s] and won ($1.45) with a pair of Deuces
Seat 10: 1nyyfan (big blind) mucked [6d 7c]



PokerStars Game #6808154797:  Hold'em Limit ($0.50/$1.00) - 2006/10/28 - 21:37:49 (ET)
Table 'Tanina' 10-max Seat #9 is the button
Seat 1: JMAC60 ($34.90 in chips) 
Seat 2: deepspace68 ($41.20 in chips) 
Seat 3: wpcrso ($19.50 in chips) 
Seat 4: Thumbber ($25.45 in chips) 
Seat 5: w.t. spartan ($12.25 in chips) 
Seat 6: TheoParrish ($10.90 in chips) 
Seat 7: lamb1142 ($14.85 in chips) 
Seat 8: 1,1,2,3,5 ($19.15 in chips) 
Seat 9: Haek82 ($32.90 in chips) 
Seat 10: 1nyyfan ($30.80 in chips) 
1nyyfan: posts small blind $0.25
JMAC60: posts big blind $0.50
*** HOLE CARDS ***
Dealt to 1,1,2,3,5 [9d 6c]
deepspace68: calls $0.50
wpcrso: folds 
Thumbber: calls $0.50
w.t. spartan: folds 
TheoParrish: folds 
lamb1142: folds 
1,1,2,3,5: folds 
Haek82: folds 
1nyyfan: calls $0.25
JMAC60: checks 
*** FLOP *** [6s 5c 3d]
1nyyfan: checks 
JMAC60: checks 
deepspace68: checks 
Thumbber: bets $0.50
1nyyfan: calls $0.50
JMAC60: folds 
deepspace68: calls $0.50
*** TURN *** [6s 5c 3d] [4c]
1nyyfan: checks 
deepspace68: checks 
Thumbber: checks 
*** RIVER *** [6s 5c 3d 4c] [5h]
1nyyfan: checks 
deepspace68: bets $1
Thumbber: folds 
1nyyfan: calls $1
*** SHOW DOWN ***
deepspace68: shows [Ah 7d] (a straight, Three to Seven)
1nyyfan: mucks hand 
deepspace68 collected $5.25 from pot
*** SUMMARY ***
Total pot $5.50 | Rake $0.25 
Board [6s 5c 3d 4c 5h]
Seat 1: JMAC60 (big blind) folded on the Flop
Seat 2: deepspace68 showed [Ah 7d] and won ($5.25) with a straight, Three to Seven
Seat 3: wpcrso folded before Flop (didn't bet)
Seat 4: Thumbber folded on the River
Seat 5: w.t. spartan folded before Flop (didn't bet)
Seat 6: TheoParrish folded before Flop (didn't bet)
Seat 7: lamb1142 folded before Flop (didn't bet)
Seat 8: 1,1,2,3,5 folded before Flop (didn't bet)
Seat 9: Haek82 (button) folded before Flop (didn't bet)
Seat 10: 1nyyfan (small blind) mucked [3c 4d]



PokerStars Game #6808166302:  Hold'em Limit ($0.50/$1.00) - 2006/10/28 - 21:38:46 (ET)
Table 'Tanina' 10-max Seat #10 is the button
Seat 1: JMAC60 ($34.40 in chips) 
Seat 2: deepspace68 ($44.45 in chips) 
Seat 3: wpcrso ($19.50 in chips) 
Seat 4: Thumbber ($24.45 in chips) 
Seat 5: w.t. spartan ($12.25 in chips) 
Seat 6: TheoParrish ($10.90 in chips) 
Seat 7: lamb1142 ($14.85 in chips) 
Seat 8: 1,1,2,3,5 ($19.15 in chips) 
Seat 9: Haek82 ($32.90 in chips) 
Seat 10: 1nyyfan ($28.80 in chips) 
JMAC60: posts small blind $0.25
deepspace68: posts big blind $0.50
*** HOLE CARDS ***
Dealt to 1,1,2,3,5 [Qd Tc]
wpcrso: folds 
Thumbber: calls $0.50
w.t. spartan: folds 
TheoParrish: folds 
lamb1142: folds 
1,1,2,3,5: folds 
Haek82: folds 
1nyyfan: folds 
JMAC60: folds 
deepspace68: checks 
*** FLOP *** [Jc Th 4d]
deepspace68: checks 
Thumbber: bets $0.50
deepspace68: calls $0.50
*** TURN *** [Jc Th 4d] [Kc]
deepspace68: checks 
Thumbber: checks 
*** RIVER *** [Jc Th 4d Kc] [8s]
deepspace68: bets $1
Thumbber: calls $1
*** SHOW DOWN ***
deepspace68: shows [6d 6h] (a pair of Sixes)
Thumbber: shows [As Ts] (a pair of Tens)
Thumbber collected $4.05 from pot
*** SUMMARY ***
Total pot $4.25 | Rake $0.20 
Board [Jc Th 4d Kc 8s]
Seat 1: JMAC60 (small blind) folded before Flop
Seat 2: deepspace68 (big blind) showed [6d 6h] and lost with a pair of Sixes
Seat 3: wpcrso folded before Flop (didn't bet)
Seat 4: Thumbber showed [As Ts] and won ($4.05) with a pair of Tens
Seat 5: w.t. spartan folded before Flop (didn't bet)
Seat 6: TheoParrish folded before Flop (didn't bet)
Seat 7: lamb1142 folded before Flop (didn't bet)
Seat 8: 1,1,2,3,5 folded before Flop (didn't bet)
Seat 9: Haek82 folded before Flop (didn't bet)
Seat 10: 1nyyfan (button) folded before Flop (didn't bet)



PokerStars Game #6808176639:  Hold'em Limit ($0.50/$1.00) - 2006/10/28 - 21:39:37 (ET)
Table 'Tanina' 10-max Seat #1 is the button
Seat 1: JMAC60 ($34.15 in chips) 
Seat 2: deepspace68 ($42.45 in chips) 
Seat 3: wpcrso ($19.50 in chips) 
Seat 4: Thumbber ($26.50 in chips) 
Seat 5: w.t. spartan ($12.25 in chips) 
Seat 6: TheoParrish ($10.90 in chips) 
Seat 7: lamb1142 ($14.85 in chips) 
Seat 8: 1,1,2,3,5 ($19.15 in chips) 
Seat 9: Haek82 ($32.90 in chips) 
Seat 10: 1nyyfan ($28.80 in chips) 
deepspace68: posts small blind $0.25
wpcrso: posts big blind $0.50
*** HOLE CARDS ***
Dealt to 1,1,2,3,5 [Ac Qs]
Thumbber: folds 
w.t. spartan: folds 
TheoParrish: folds 
lamb1142: folds 
1,1,2,3,5: raises $0.50 to $1
Haek82: folds 
1nyyfan: calls $1
JMAC60: folds 
deepspace68: folds 
wpcrso: calls $0.50
*** FLOP *** [6c 5d Jh]
wpcrso: checks 
1,1,2,3,5: checks 
1nyyfan: checks 
*** TURN *** [6c 5d Jh] [Jd]
wpcrso: checks 
1,1,2,3,5: checks 
1nyyfan: checks 
*** RIVER *** [6c 5d Jh Jd] [Js]
wpcrso: checks 
1,1,2,3,5: bets $1
1nyyfan: folds 
wpcrso: folds 
1,1,2,3,5 collected $3.10 from pot
1,1,2,3,5: doesn't show hand 
*** SUMMARY ***
Total pot $3.25 | Rake $0.15 
Board [6c 5d Jh Jd Js]
Seat 1: JMAC60 (button) folded before Flop (didn't bet)
Seat 2: deepspace68 (small blind) folded before Flop
Seat 3: wpcrso (big blind) folded on the River
Seat 4: Thumbber folded before Flop (didn't bet)
Seat 5: w.t. spartan folded before Flop (didn't bet)
Seat 6: TheoParrish folded before Flop (didn't bet)
Seat 7: lamb1142 folded before Flop (didn't bet)
Seat 8: 1,1,2,3,5 collected ($3.10)
Seat 9: Haek82 folded before Flop (didn't bet)
Seat 10: 1nyyfan folded on the River



PokerStars Game #6808187387:  Hold'em Limit ($0.50/$1.00) - 2006/10/28 - 21:40:30 (ET)
Table 'Tanina' 10-max Seat #2 is the button
Seat 1: JMAC60 ($34.15 in chips) 
Seat 2: deepspace68 ($42.20 in chips) 
Seat 3: wpcrso ($18.50 in chips) 
Seat 4: Thumbber ($26.50 in chips) 
Seat 5: w.t. spartan ($12.25 in chips) 
Seat 6: TheoParrish ($10.90 in chips) 
Seat 7: lamb1142 ($14.85 in chips) 
Seat 8: 1,1,2,3,5 ($21.25 in chips) 
Seat 9: Haek82 ($32.90 in chips) 
Seat 10: 1nyyfan ($27.80 in chips) 
wpcrso: posts small blind $0.25
Thumbber: posts big blind $0.50
*** HOLE CARDS ***
Dealt to 1,1,2,3,5 [2h Qs]
w.t. spartan: folds 
TheoParrish: folds 
lamb1142: folds 
1,1,2,3,5: folds 
Haek82: folds 
1nyyfan: folds 
JMAC60: folds 
deepspace68: folds 
wpcrso: folds 
Thumbber collected $0.50 from pot
Thumbber: doesn't show hand 
*** SUMMARY ***
Total pot $0.50 | Rake $0 
Seat 1: JMAC60 folded before Flop (didn't bet)
Seat 2: deepspace68 (button) folded before Flop (didn't bet)
Seat 3: wpcrso (small blind) folded before Flop
Seat 4: Thumbber (big blind) collected ($0.50)
Seat 5: w.t. spartan folded before Flop (didn't bet)
Seat 6: TheoParrish folded before Flop (didn't bet)
Seat 7: lamb1142 folded before Flop (didn't bet)
Seat 8: 1,1,2,3,5 folded before Flop (didn't bet)
Seat 9: Haek82 folded before Flop (didn't bet)
Seat 10: 1nyyfan folded before Flop (didn't bet)



PokerStars Game #6808191016:  Hold'em Limit ($0.50/$1.00) - 2006/10/28 - 21:40:48 (ET)
Table 'Tanina' 10-max Seat #3 is the button
Seat 1: JMAC60 ($34.15 in chips) 
Seat 2: deepspace68 ($42.20 in chips) 
Seat 3: wpcrso ($18.25 in chips) 
Seat 4: Thumbber ($26.75 in chips) 
Seat 5: w.t. spartan ($12.25 in chips) 
Seat 6: TheoParrish ($10.90 in chips) 
Seat 7: lamb1142 ($14.85 in chips) 
Seat 8: 1,1,2,3,5 ($21.25 in chips) 
Seat 9: Haek82 ($32.90 in chips) 
Seat 10: 1nyyfan ($27.80 in chips) 
Thumbber: posts small blind $0.25
w.t. spartan: posts big blind $0.50
*** HOLE CARDS ***
Dealt to 1,1,2,3,5 [Ah 3d]
TheoParrish: folds 
TheoParrish leaves the table
lamb1142: folds 
1,1,2,3,5: folds 
Haek82: folds 
1nyyfan: folds 
JMAC60: raises $0.50 to $1
deepspace68: folds 
wpcrso: folds 
Thumbber: folds 
w.t. spartan: calls $0.50
*** FLOP *** [8d Kd 8c]
w.t. spartan: checks 
JMAC60: bets $0.50
w.t. spartan: calls $0.50
*** TURN *** [8d Kd 8c] [4c]
w.t. spartan: checks 
JMAC60: bets $1
w.t. spartan: calls $1
*** RIVER *** [8d Kd 8c 4c] [Ad]
w.t. spartan: checks 
JMAC60: checks 
*** SHOW DOWN ***
w.t. spartan: shows [Ac Jh] (two pair, Aces and Eights)
JMAC60: mucks hand 
w.t. spartan collected $5 from pot
*** SUMMARY ***
Total pot $5.25 | Rake $0.25 
Board [8d Kd 8c 4c Ad]
Seat 1: JMAC60 mucked [Kh Th]
Seat 2: deepspace68 folded before Flop (didn't bet)
Seat 3: wpcrso (button) folded before Flop (didn't bet)
Seat 4: Thumbber (small blind) folded before Flop
Seat 5: w.t. spartan (big blind) showed [Ac Jh] and won ($5) with two pair, Aces and Eights
Seat 6: TheoParrish folded before Flop (didn't bet)
Seat 7: lamb1142 folded before Flop (didn't bet)
Seat 8: 1,1,2,3,5 folded before Flop (didn't bet)
Seat 9: Haek82 folded before Flop (didn't bet)
Seat 10: 1nyyfan folded before Flop (didn't bet)



PokerStars Game #6808198907:  Hold'em Limit ($0.50/$1.00) - 2006/10/28 - 21:41:27 (ET)
Table 'Tanina' 10-max Seat #4 is the button
Seat 1: JMAC60 ($31.65 in chips) 
Seat 2: deepspace68 ($42.20 in chips) 
Seat 3: wpcrso ($18.25 in chips) 
Seat 4: Thumbber ($26.50 in chips) 
Seat 5: w.t. spartan ($14.75 in chips) 
Seat 7: lamb1142 ($14.85 in chips) 
Seat 8: 1,1,2,3,5 ($21.25 in chips) 
Seat 9: Haek82 ($32.90 in chips) 
Seat 10: 1nyyfan ($27.80 in chips) 
w.t. spartan: posts small blind $0.25
lamb1142: posts big blind $0.50
*** HOLE CARDS ***
Dealt to 1,1,2,3,5 [Ad 5h]
1,1,2,3,5: folds 
Haek82: folds 
1nyyfan: folds 
JMAC60: calls $0.50
deepspace68: calls $0.50
wpcrso: folds 
Thumbber: folds 
w.t. spartan: folds 
lamb1142: checks 
*** FLOP *** [5s 5c Ks]
lamb1142: checks 
JMAC60: bets $0.50
deepspace68: calls $0.50
lamb1142: calls $0.50
*** TURN *** [5s 5c Ks] [3s]
lamb1142: bets $1
JMAC60: calls $1
deepspace68: folds 
*** RIVER *** [5s 5c Ks 3s] [8c]
lamb1142: bets $1
JMAC60: calls $1
*** SHOW DOWN ***
lamb1142: shows [Kh Jc] (two pair, Kings and Fives)
JMAC60: mucks hand 
lamb1142 collected $6.90 from pot
*** SUMMARY ***
Total pot $7.25 | Rake $0.35 
Board [5s 5c Ks 3s 8c]
Seat 1: JMAC60 mucked [Kd Ts]
Seat 2: deepspace68 folded on the Turn
Seat 3: wpcrso folded before Flop (didn't bet)
Seat 4: Thumbber (button) folded before Flop (didn't bet)
Seat 5: w.t. spartan (small blind) folded before Flop
Seat 7: lamb1142 (big blind) showed [Kh Jc] and won ($6.90) with two pair, Kings and Fives
Seat 8: 1,1,2,3,5 folded before Flop (didn't bet)
Seat 9: Haek82 folded before Flop (didn't bet)
Seat 10: 1nyyfan folded before Flop (didn't bet)



PokerStars Game #6808208612:  Hold'em Limit ($0.50/$1.00) - 2006/10/28 - 21:42:17 (ET)
Table 'Tanina' 10-max Seat #5 is the button
Seat 1: JMAC60 ($28.65 in chips) 
Seat 2: deepspace68 ($41.20 in chips) 
Seat 3: wpcrso ($18.25 in chips) 
Seat 4: Thumbber ($26.50 in chips) 
Seat 5: w.t. spartan ($14.50 in chips) 
Seat 7: lamb1142 ($18.75 in chips) 
Seat 8: 1,1,2,3,5 ($21.25 in chips) 
Seat 9: Haek82 ($32.90 in chips) 
Seat 10: 1nyyfan ($27.80 in chips) 
lamb1142: posts small blind $0.25
1,1,2,3,5: posts big blind $0.50
*** HOLE CARDS ***
Dealt to 1,1,2,3,5 [Ac 7h]
Haek82: calls $0.50
1nyyfan: calls $0.50
JMAC60: folds 
deepspace68: folds 
wpcrso: folds 
Thumbber: folds 
w.t. spartan: calls $0.50
lamb1142: folds 
1,1,2,3,5: checks 
*** FLOP *** [Tc 3c 8s]
1,1,2,3,5: checks 
Haek82: checks 
1nyyfan: bets $0.50
w.t. spartan: raises $0.50 to $1
1,1,2,3,5: folds 
Haek82: folds 
1nyyfan: calls $0.50
*** TURN *** [Tc 3c 8s] [5h]
1nyyfan: checks 
w.t. spartan: bets $1
1nyyfan: calls $1
*** RIVER *** [Tc 3c 8s 5h] [Jh]
1nyyfan: checks 
w.t. spartan: checks 
*** SHOW DOWN ***
1nyyfan: shows [Qs Td] (a pair of Tens)
w.t. spartan: shows [Ts Ad] (a pair of Tens - Ace kicker)
w.t. spartan collected $5.95 from pot
*** SUMMARY ***
Total pot $6.25 | Rake $0.30 
Board [Tc 3c 8s 5h Jh]
Seat 1: JMAC60 folded before Flop (didn't bet)
Seat 2: deepspace68 folded before Flop (didn't bet)
Seat 3: wpcrso folded before Flop (didn't bet)
Seat 4: Thumbber folded before Flop (didn't bet)
Seat 5: w.t. spartan (button) showed [Ts Ad] and won ($5.95) with a pair of Tens
Seat 7: lamb1142 (small blind) folded before Flop
Seat 8: 1,1,2,3,5 (big blind) folded on the Flop
Seat 9: Haek82 folded on the Flop
Seat 10: 1nyyfan showed [Qs Td] and lost with a pair of Tens



PokerStars Game #6808217989:  Hold'em Limit ($0.50/$1.00) - 2006/10/28 - 21:43:02 (ET)
Table 'Tanina' 10-max Seat #7 is the button
Seat 1: JMAC60 ($28.65 in chips) 
Seat 2: deepspace68 ($41.20 in chips) 
Seat 3: wpcrso ($18.25 in chips) 
Seat 4: Thumbber ($26.50 in chips) 
Seat 5: w.t. spartan ($17.95 in chips) 
Seat 7: lamb1142 ($18.50 in chips) 
Seat 8: 1,1,2,3,5 ($20.75 in chips) 
Seat 9: Haek82 ($32.40 in chips) 
Seat 10: 1nyyfan ($25.30 in chips) 
1,1,2,3,5: posts small blind $0.25
Haek82: posts big blind $0.50
*** HOLE CARDS ***
Dealt to 1,1,2,3,5 [Ah Js]
1nyyfan: folds 
JMAC60: folds 
deepspace68: folds 
wpcrso: folds 
Thumbber: folds 
w.t. spartan: folds 
lamb1142: calls $0.50
1,1,2,3,5: raises $0.50 to $1
Haek82: calls $0.50
lamb1142: raises $0.50 to $1.50
1,1,2,3,5: calls $0.50
Haek82: calls $0.50
*** FLOP *** [Qc Kd 4c]
1,1,2,3,5: bets $0.50
Haek82: calls $0.50
lamb1142: raises $0.50 to $1
1,1,2,3,5: calls $0.50
Haek82: calls $0.50
*** TURN *** [Qc Kd 4c] [Kc]
1,1,2,3,5: checks 
Haek82: checks 
lamb1142: bets $1
1,1,2,3,5: folds 
Haek82: calls $1
*** RIVER *** [Qc Kd 4c Kc] [2h]
Haek82: checks 
lamb1142: bets $1
Haek82: folds 
lamb1142 collected $9.05 from pot
*** SUMMARY ***
Total pot $9.50 | Rake $0.45 
Board [Qc Kd 4c Kc 2h]
Seat 1: JMAC60 folded before Flop (didn't bet)
Seat 2: deepspace68 folded before Flop (didn't bet)
Seat 3: wpcrso folded before Flop (didn't bet)
Seat 4: Thumbber folded before Flop (didn't bet)
Seat 5: w.t. spartan folded before Flop (didn't bet)
Seat 7: lamb1142 (button) collected ($9.05)
Seat 8: 1,1,2,3,5 (small blind) folded on the Turn
Seat 9: Haek82 (big blind) folded on the River
Seat 10: 1nyyfan folded before Flop (didn't bet)



PokerStars Game #6808228945:  Hold'em Limit ($0.50/$1.00) - 2006/10/28 - 21:43:56 (ET)
Table 'Tanina' 10-max Seat #8 is the button
Seat 1: JMAC60 ($28.65 in chips) 
Seat 2: deepspace68 ($41.20 in chips) 
Seat 3: wpcrso ($18.25 in chips) 
Seat 4: Thumbber ($26.50 in chips) 
Seat 5: w.t. spartan ($17.95 in chips) 
Seat 7: lamb1142 ($24.05 in chips) 
Seat 8: 1,1,2,3,5 ($18.25 in chips) 
Seat 9: Haek82 ($28.90 in chips) 
Seat 10: 1nyyfan ($25.30 in chips) 
Haek82: posts small blind $0.25
1nyyfan: posts big blind $0.50
*** HOLE CARDS ***
Dealt to 1,1,2,3,5 [2h Qs]
JMAC60: calls $0.50
deepspace68: folds 
wpcrso: folds 
Thumbber: folds 
w.t. spartan: folds 
lamb1142: folds 
1,1,2,3,5: folds 
Haek82: folds 
1nyyfan: checks 
*** FLOP *** [6c 5c 9c]
1nyyfan: checks 
JMAC60: bets $0.50
1nyyfan: folds 
JMAC60 collected $1.20 from pot
JMAC60: doesn't show hand 
*** SUMMARY ***
Total pot $1.25 | Rake $0.05 
Board [6c 5c 9c]
Seat 1: JMAC60 collected ($1.20)
Seat 2: deepspace68 folded before Flop (didn't bet)
Seat 3: wpcrso folded before Flop (didn't bet)
Seat 4: Thumbber folded before Flop (didn't bet)
Seat 5: w.t. spartan folded before Flop (didn't bet)
Seat 7: lamb1142 folded before Flop (didn't bet)
Seat 8: 1,1,2,3,5 (button) folded before Flop (didn't bet)
Seat 9: Haek82 (small blind) folded before Flop
Seat 10: 1nyyfan (big blind) folded on the Flop



PokerStars Game #6808233640:  Hold'em Limit ($0.50/$1.00) - 2006/10/28 - 21:44:20 (ET)
Table 'Tanina' 10-max Seat #9 is the button
Seat 1: JMAC60 ($29.35 in chips) 
Seat 2: deepspace68 ($41.20 in chips) 
Seat 3: wpcrso ($18.25 in chips) 
Seat 4: Thumbber ($26.50 in chips) 
Seat 5: w.t. spartan ($17.95 in chips) 
Seat 7: lamb1142 ($24.05 in chips) 
Seat 8: 1,1,2,3,5 ($18.25 in chips) 
Seat 9: Haek82 ($28.65 in chips) 
Seat 10: 1nyyfan ($24.80 in chips) 
1nyyfan: posts small blind $0.25
JMAC60: posts big blind $0.50
*** HOLE CARDS ***
Dealt to 1,1,2,3,5 [5c 6c]
deepspace68: calls $0.50
wpcrso: calls $0.50
ericlb111 joins the table at seat #6 
Thumbber: folds 
w.t. spartan: folds 
lamb1142: folds 
1,1,2,3,5: folds 
Haek82: folds 
1nyyfan: calls $0.25
JMAC60: checks 
*** FLOP *** [5s Kc 7d]
1nyyfan: checks 
JMAC60: checks 
deepspace68: checks 
wpcrso: bets $0.50
1nyyfan: calls $0.50
JMAC60: raises $0.50 to $1
deepspace68: folds 
wpcrso: calls $0.50
1nyyfan: calls $0.50
*** TURN *** [5s Kc 7d] [Ad]
1nyyfan: checks 
JMAC60: bets $1
wpcrso: calls $1
1nyyfan: folds 
*** RIVER *** [5s Kc 7d Ad] [Jd]
JMAC60: checks 
wpcrso: bets $1
JMAC60: calls $1
*** SHOW DOWN ***
wpcrso: shows [Kd Qd] (a flush, Ace high)
JMAC60: mucks hand 
wpcrso collected $8.60 from pot
*** SUMMARY ***
Total pot $9 | Rake $0.40 
Board [5s Kc 7d Ad Jd]
Seat 1: JMAC60 (big blind) mucked [Kh 8h]
Seat 2: deepspace68 folded on the Flop
Seat 3: wpcrso showed [Kd Qd] and won ($8.60) with a flush, Ace high
Seat 4: Thumbber folded before Flop (didn't bet)
Seat 5: w.t. spartan folded before Flop (didn't bet)
Seat 7: lamb1142 folded before Flop (didn't bet)
Seat 8: 1,1,2,3,5 folded before Flop (didn't bet)
Seat 9: Haek82 (button) folded before Flop (didn't bet)
Seat 10: 1nyyfan (small blind) folded on the Turn



PokerStars Game #6808246975:  Hold'em Limit ($0.50/$1.00) - 2006/10/28 - 21:45:27 (ET)
Table 'Tanina' 10-max Seat #10 is the button
Seat 1: JMAC60 ($25.85 in chips) 
Seat 2: deepspace68 ($40.70 in chips) 
Seat 3: wpcrso ($23.35 in chips) 
Seat 4: Thumbber ($26.50 in chips) 
Seat 5: w.t. spartan ($17.95 in chips) 
Seat 7: lamb1142 ($24.05 in chips) 
Seat 8: 1,1,2,3,5 ($18.25 in chips) 
Seat 9: Haek82 ($28.65 in chips) 
Seat 10: 1nyyfan ($23.30 in chips) 
JMAC60: posts small blind $0.25
deepspace68: posts big blind $0.50
ericlb111: sits out 
*** HOLE CARDS ***
Dealt to 1,1,2,3,5 [4d 3d]
wpcrso: folds 
Thumbber: folds 
w.t. spartan: calls $0.50
lamb1142: folds 
1,1,2,3,5: folds 
Haek82: folds 
1nyyfan: folds 
JMAC60: calls $0.25
deepspace68: checks 
*** FLOP *** [Kc Qd 5d]
JMAC60: checks 
deepspace68: bets $0.50
w.t. spartan: raises $0.50 to $1
JMAC60: folds 
deepspace68: raises $0.50 to $1.50
w.t. spartan: calls $0.50
*** TURN *** [Kc Qd 5d] [Ah]
deepspace68: bets $1
w.t. spartan: calls $1
*** RIVER *** [Kc Qd 5d Ah] [2s]
deepspace68: bets $1
w.t. spartan: folds 
deepspace68 collected $6.20 from pot
*** SUMMARY ***
Total pot $6.50 | Rake $0.30 
Board [Kc Qd 5d Ah 2s]
Seat 1: JMAC60 (small blind) folded on the Flop
Seat 2: deepspace68 (big blind) collected ($6.20)
Seat 3: wpcrso folded before Flop (didn't bet)
Seat 4: Thumbber folded before Flop (didn't bet)
Seat 5: w.t. spartan folded on the River
Seat 7: lamb1142 folded before Flop (didn't bet)
Seat 8: 1,1,2,3,5 folded before Flop (didn't bet)
Seat 9: Haek82 folded before Flop (didn't bet)
Seat 10: 1nyyfan (button) folded before Flop (didn't bet)



PokerStars Game #6808257465:  Hold'em Limit ($0.50/$1.00) - 2006/10/28 - 21:46:20 (ET)
Table 'Tanina' 10-max Seat #1 is the button
Seat 1: JMAC60 ($25.35 in chips) 
Seat 2: deepspace68 ($43.90 in chips) 
Seat 3: wpcrso ($23.35 in chips) 
Seat 4: Thumbber ($26.50 in chips) 
Seat 5: w.t. spartan ($14.95 in chips) 
Seat 7: lamb1142 ($24.05 in chips) 
Seat 8: 1,1,2,3,5 ($18.25 in chips) 
Seat 9: Haek82 ($28.65 in chips) 
Seat 10: 1nyyfan ($23.30 in chips) 
deepspace68: posts small blind $0.25
wpcrso: posts big blind $0.50
ericlb111: sits out 
*** HOLE CARDS ***
Dealt to 1,1,2,3,5 [9d 6c]
Thumbber: folds 
w.t. spartan: folds 
lamb1142: raises $0.50 to $1
1,1,2,3,5: folds 
Haek82: folds 
1nyyfan: folds 
JMAC60: folds 
deepspace68: folds 
wpcrso: calls $0.50
*** FLOP *** [5d 3c Qd]
wpcrso: checks 
lamb1142: bets $0.50
wpcrso: folds 
lamb1142 collected $2.15 from pot
*** SUMMARY ***
Total pot $2.25 | Rake $0.10 
Board [5d 3c Qd]
Seat 1: JMAC60 (button) folded before Flop (didn't bet)
Seat 2: deepspace68 (small blind) folded before Flop
Seat 3: wpcrso (big blind) folded on the Flop
Seat 4: Thumbber folded before Flop (didn't bet)
Seat 5: w.t. spartan folded before Flop (didn't bet)
Seat 7: lamb1142 collected ($2.15)
Seat 8: 1,1,2,3,5 folded before Flop (didn't bet)
Seat 9: Haek82 folded before Flop (didn't bet)
Seat 10: 1nyyfan folded before Flop (didn't bet)



PokerStars Game #6808264259:  Hold'em Limit ($0.50/$1.00) - 2006/10/28 - 21:46:54 (ET)
Table 'Tanina' 10-max Seat #2 is the button
Seat 1: JMAC60 ($25.35 in chips) 
Seat 2: deepspace68 ($43.65 in chips) 
Seat 3: wpcrso ($22.35 in chips) 
Seat 4: Thumbber ($26.50 in chips) 
Seat 5: w.t. spartan ($14.95 in chips) 
Seat 7: lamb1142 ($25.20 in chips) 
Seat 8: 1,1,2,3,5 ($18.25 in chips) 
Seat 9: Haek82 ($28.65 in chips) 
Seat 10: 1nyyfan ($23.30 in chips) 
wpcrso: posts small blind $0.25
Thumbber: posts big blind $0.50
ericlb111: sits out 
*** HOLE CARDS ***
Dealt to 1,1,2,3,5 [7d 8c]
w.t. spartan: calls $0.50
lamb1142: calls $0.50
1,1,2,3,5: folds 
Haek82: folds 
1nyyfan: folds 
JMAC60: raises $0.50 to $1
deepspace68: folds 
wpcrso: folds 
Thumbber: calls $0.50
w.t. spartan: calls $0.50
lamb1142: calls $0.50
*** FLOP *** [5s Td 8d]
Thumbber: checks 
w.t. spartan: checks 
lamb1142: checks 
JMAC60: bets $0.50
Thumbber: raises $0.50 to $1
w.t. spartan: calls $1
lamb1142: folds 
JMAC60: folds 
*** TURN *** [5s Td 8d] [5h]
Thumbber: checks 
w.t. spartan: checks 
*** RIVER *** [5s Td 8d 5h] [As]
Thumbber: bets $1
w.t. spartan: folds 
Thumbber collected $6.45 from pot
Thumbber: doesn't show hand 
*** SUMMARY ***
Total pot $6.75 | Rake $0.30 
Board [5s Td 8d 5h As]
Seat 1: JMAC60 folded on the Flop
Seat 2: deepspace68 (button) folded before Flop (didn't bet)
Seat 3: wpcrso (small blind) folded before Flop
Seat 4: Thumbber (big blind) collected ($6.45)
Seat 5: w.t. spartan folded on the River
Seat 7: lamb1142 folded on the Flop
Seat 8: 1,1,2,3,5 folded before Flop (didn't bet)
Seat 9: Haek82 folded before Flop (didn't bet)
Seat 10: 1nyyfan folded before Flop (didn't bet)



PokerStars Game #6808275899:  Hold'em Limit ($0.50/$1.00) - 2006/10/28 - 21:47:47 (ET)
Table 'Tanina' 10-max Seat #3 is the button
Seat 1: JMAC60 ($23.85 in chips) 
Seat 2: deepspace68 ($43.65 in chips) 
Seat 3: wpcrso ($22.10 in chips) 
Seat 4: Thumbber ($30.95 in chips) 
Seat 5: w.t. spartan ($12.95 in chips) 
Seat 7: lamb1142 ($24.20 in chips) 
Seat 8: 1,1,2,3,5 ($18.25 in chips) 
Seat 9: Haek82 ($28.65 in chips) 
Seat 10: 1nyyfan ($23.30 in chips) 
Thumbber: posts small blind $0.25
w.t. spartan: posts big blind $0.50
ericlb111: sits out 
*** HOLE CARDS ***
Dealt to 1,1,2,3,5 [5d Jc]
lamb1142: folds 
1,1,2,3,5: folds 
Haek82: folds 
1nyyfan: folds 
JMAC60: folds 
deepspace68: folds 
wpcrso: folds 
Thumbber: calls $0.25
w.t. spartan: checks 
*** FLOP *** [6d 9c 2c]
Thumbber: checks 
w.t. spartan: checks 
*** TURN *** [6d 9c 2c] [5s]
Thumbber: checks 
w.t. spartan: checks 
*** RIVER *** [6d 9c 2c 5s] [2h]
Thumbber: checks 
w.t. spartan: checks 
*** SHOW DOWN ***
Thumbber: shows [As Th] (a pair of Deuces)
w.t. spartan: mucks hand 
Thumbber collected $0.95 from pot
*** SUMMARY ***
Total pot $1 | Rake $0.05 
Board [6d 9c 2c 5s 2h]
Seat 1: JMAC60 folded before Flop (didn't bet)
Seat 2: deepspace68 folded before Flop (didn't bet)
Seat 3: wpcrso (button) folded before Flop (didn't bet)
Seat 4: Thumbber (small blind) showed [As Th] and won ($0.95) with a pair of Deuces
Seat 5: w.t. spartan (big blind) mucked [Ts 8h]
Seat 7: lamb1142 folded before Flop (didn't bet)
Seat 8: 1,1,2,3,5 folded before Flop (didn't bet)
Seat 9: Haek82 folded before Flop (didn't bet)
Seat 10: 1nyyfan folded before Flop (didn't bet)



PokerStars Game #6808283027:  Hold'em Limit ($0.50/$1.00) - 2006/10/28 - 21:48:23 (ET)
Table 'Tanina' 10-max Seat #4 is the button
Seat 1: JMAC60 ($23.85 in chips) 
Seat 2: deepspace68 ($43.65 in chips) 
Seat 3: wpcrso ($22.10 in chips) 
Seat 4: Thumbber ($31.40 in chips) 
Seat 5: w.t. spartan ($12.45 in chips) 
Seat 6: ericlb111 ($20 in chips) 
Seat 7: lamb1142 ($24.20 in chips) 
Seat 8: 1,1,2,3,5 ($18.25 in chips) 
Seat 9: Haek82 ($28.65 in chips) 
Seat 10: 1nyyfan ($23.30 in chips) 
w.t. spartan: posts small blind $0.25
ericlb111: posts big blind $0.50
*** HOLE CARDS ***
Dealt to 1,1,2,3,5 [8c 3d]
lamb1142: calls $0.50
1,1,2,3,5: folds 
Haek82: raises $0.50 to $1
1nyyfan: folds 
JMAC60: folds 
deepspace68: folds 
wpcrso: folds 
Thumbber: folds 
w.t. spartan: calls $0.75
ericlb111: folds 
lamb1142: calls $0.50
*** FLOP *** [4d 4s 8s]
w.t. spartan: checks 
lamb1142: checks 
Haek82: bets $0.50
w.t. spartan: calls $0.50
lamb1142: folds 
*** TURN *** [4d 4s 8s] [Qc]
w.t. spartan: checks 
Haek82: bets $1
w.t. spartan: folds 
Haek82 collected $4.30 from pot
*** SUMMARY ***
Total pot $4.50 | Rake $0.20 
Board [4d 4s 8s Qc]
Seat 1: JMAC60 folded before Flop (didn't bet)
Seat 2: deepspace68 folded before Flop (didn't bet)
Seat 3: wpcrso folded before Flop (didn't bet)
Seat 4: Thumbber (button) folded before Flop (didn't bet)
Seat 5: w.t. spartan (small blind) folded on the Turn
Seat 6: ericlb111 (big blind) folded before Flop
Seat 7: lamb1142 folded on the Flop
Seat 8: 1,1,2,3,5 folded before Flop (didn't bet)
Seat 9: Haek82 collected ($4.30)
Seat 10: 1nyyfan folded before Flop (didn't bet)



PokerStars Game #6808292429:  Hold'em Limit ($0.50/$1.00) - 2006/10/28 - 21:49:07 (ET)
Table 'Tanina' 10-max Seat #5 is the button
Seat 1: JMAC60 ($23.85 in chips) 
Seat 2: deepspace68 ($43.65 in chips) 
Seat 3: wpcrso ($22.10 in chips) 
Seat 4: Thumbber ($31.40 in chips) 
Seat 5: w.t. spartan ($10.95 in chips) 
Seat 6: ericlb111 ($19.50 in chips) 
Seat 7: lamb1142 ($23.20 in chips) 
Seat 8: 1,1,2,3,5 ($18.25 in chips) 
Seat 9: Haek82 ($31.45 in chips) 
Seat 10: 1nyyfan ($23.30 in chips) 
ericlb111: posts small blind $0.25
lamb1142: posts big blind $0.50
*** HOLE CARDS ***
Dealt to 1,1,2,3,5 [7d Kc]
1,1,2,3,5: folds 
Haek82: calls $0.50
1nyyfan: folds 
JMAC60: folds 
deepspace68: folds 
wpcrso: folds 
Thumbber: calls $0.50
w.t. spartan: folds 
ericlb111: folds 
lamb1142: raises $0.50 to $1
Haek82: calls $0.50
Thumbber: calls $0.50
*** FLOP *** [3d 7s 5d]
lamb1142: bets $0.50
Haek82: calls $0.50
Thumbber: folds 
*** TURN *** [3d 7s 5d] [Js]
lamb1142: bets $1
Haek82: raises $1 to $2
lamb1142: calls $1
*** RIVER *** [3d 7s 5d Js] [2c]
lamb1142: checks 
Haek82: bets $1
lamb1142: calls $1
*** SHOW DOWN ***
Haek82: shows [9s 9d] (a pair of Nines)
lamb1142: shows [Ac Ad] (a pair of Aces)
lamb1142 collected $9.80 from pot
*** SUMMARY ***
Total pot $10.25 | Rake $0.45 
Board [3d 7s 5d Js 2c]
Seat 1: JMAC60 folded before Flop (didn't bet)
Seat 2: deepspace68 folded before Flop (didn't bet)
Seat 3: wpcrso folded before Flop (didn't bet)
Seat 4: Thumbber folded on the Flop
Seat 5: w.t. spartan (button) folded before Flop (didn't bet)
Seat 6: ericlb111 (small blind) folded before Flop
Seat 7: lamb1142 (big blind) showed [Ac Ad] and won ($9.80) with a pair of Aces
Seat 8: 1,1,2,3,5 folded before Flop (didn't bet)
Seat 9: Haek82 showed [9s 9d] and lost with a pair of Nines
Seat 10: 1nyyfan folded before Flop (didn't bet)



PokerStars Game #6808304763:  Hold'em Limit ($0.50/$1.00) - 2006/10/28 - 21:50:06 (ET)
Table 'Tanina' 10-max Seat #6 is the button
Seat 1: JMAC60 ($23.85 in chips) 
Seat 2: deepspace68 ($43.65 in chips) 
Seat 3: wpcrso ($22.10 in chips) 
Seat 4: Thumbber ($30.40 in chips) 
Seat 5: w.t. spartan ($10.95 in chips) 
Seat 6: ericlb111 ($19.25 in chips) 
Seat 7: lamb1142 ($28.50 in chips) 
Seat 8: 1,1,2,3,5 ($18.25 in chips) 
Seat 9: Haek82 ($26.95 in chips) 
Seat 10: 1nyyfan ($23.30 in chips) 
lamb1142: posts small blind $0.25
1,1,2,3,5: posts big blind $0.50
*** HOLE CARDS ***
Dealt to 1,1,2,3,5 [7s 4d]
Haek82: folds 
1nyyfan: folds 
JMAC60: folds 
deepspace68: folds 
wpcrso: folds 
Thumbber: calls $0.50
w.t. spartan: folds 
ericlb111: folds 
lamb1142: calls $0.25
1,1,2,3,5: checks 
*** FLOP *** [5d 2h 9c]
lamb1142: checks 
1,1,2,3,5: checks 
Thumbber: bets $0.50
lamb1142: calls $0.50
1,1,2,3,5: folds 
*** TURN *** [5d 2h 9c] [4c]
lamb1142: checks 
Thumbber: checks 
*** RIVER *** [5d 2h 9c 4c] [Th]
lamb1142: checks 
Thumbber: checks 
*** SHOW DOWN ***
lamb1142: shows [Kd Qd] (high card King)
Thumbber: mucks hand 
lamb1142 collected $2.40 from pot
*** SUMMARY ***
Total pot $2.50 | Rake $0.10 
Board [5d 2h 9c 4c Th]
Seat 1: JMAC60 folded before Flop (didn't bet)
Seat 2: deepspace68 folded before Flop (didn't bet)
Seat 3: wpcrso folded before Flop (didn't bet)
Seat 4: Thumbber mucked [Qs Js]
Seat 5: w.t. spartan folded before Flop (didn't bet)
Seat 6: ericlb111 (button) folded before Flop (didn't bet)
Seat 7: lamb1142 (small blind) showed [Kd Qd] and won ($2.40) with high card King
Seat 8: 1,1,2,3,5 (big blind) folded on the Flop
Seat 9: Haek82 folded before Flop (didn't bet)
Seat 10: 1nyyfan folded before Flop (didn't bet)



PokerStars Game #6808317328:  Hold'em Limit ($0.50/$1.00) - 2006/10/28 - 21:51:06 (ET)
Table 'Tanina' 10-max Seat #7 is the button
Seat 1: JMAC60 ($23.85 in chips) 
Seat 2: deepspace68 ($43.65 in chips) 
Seat 3: wpcrso ($22.10 in chips) 
Seat 4: Thumbber ($29.40 in chips) 
Seat 5: w.t. spartan ($10.95 in chips) 
Seat 6: ericlb111 ($19.25 in chips) 
Seat 7: lamb1142 ($29.90 in chips) 
Seat 8: 1,1,2,3,5 ($17.75 in chips) 
Seat 9: Haek82 ($26.95 in chips) 
Seat 10: 1nyyfan ($23.30 in chips) 
1,1,2,3,5: posts small blind $0.25
Haek82: posts big blind $0.50
*** HOLE CARDS ***
Dealt to 1,1,2,3,5 [9c 9s]
1nyyfan: folds 
JMAC60: folds 
deepspace68: folds 
wpcrso: folds 
Thumbber: calls $0.50
w.t. spartan: folds 
ericlb111: folds 
lamb1142: folds 
1,1,2,3,5: raises $0.50 to $1
Haek82: calls $0.50
Thumbber: calls $0.50
*** FLOP *** [As Kh Qc]
1,1,2,3,5: checks 
Haek82: checks 
Thumbber: checks 
*** TURN *** [As Kh Qc] [7s]
1,1,2,3,5: checks 
Haek82: bets $1
Thumbber: folds 
1,1,2,3,5: folds 
Haek82 collected $2.85 from pot
*** SUMMARY ***
Total pot $3 | Rake $0.15 
Board [As Kh Qc 7s]
Seat 1: JMAC60 folded before Flop (didn't bet)
Seat 2: deepspace68 folded before Flop (didn't bet)
Seat 3: wpcrso folded before Flop (didn't bet)
Seat 4: Thumbber folded on the Turn
Seat 5: w.t. spartan folded before Flop (didn't bet)
Seat 6: ericlb111 folded before Flop (didn't bet)
Seat 7: lamb1142 (button) folded before Flop (didn't bet)
Seat 8: 1,1,2,3,5 (small blind) folded on the Turn
Seat 9: Haek82 (big blind) collected ($2.85)
Seat 10: 1nyyfan folded before Flop (didn't bet)



PokerStars Game #6808327338:  Hold'em Limit ($0.50/$1.00) - 2006/10/28 - 21:51:55 (ET)
Table 'Tanina' 10-max Seat #8 is the button
Seat 1: JMAC60 ($23.85 in chips) 
Seat 2: deepspace68 ($43.65 in chips) 
Seat 3: wpcrso ($22.10 in chips) 
Seat 4: Thumbber ($28.40 in chips) 
Seat 5: w.t. spartan ($10.95 in chips) 
Seat 6: ericlb111 ($19.25 in chips) 
Seat 7: lamb1142 ($29.90 in chips) 
Seat 8: 1,1,2,3,5 ($16.75 in chips) 
Seat 9: Haek82 ($28.80 in chips) 
Seat 10: 1nyyfan ($23.30 in chips) 
Haek82: posts small blind $0.25
1nyyfan: posts big blind $0.50
*** HOLE CARDS ***
Dealt to 1,1,2,3,5 [2c Qh]
JMAC60: folds 
deepspace68: folds 
wpcrso: calls $0.50
Thumbber: folds 
w.t. spartan: folds 
ericlb111: folds 
lamb1142: raises $0.50 to $1
1,1,2,3,5: folds 
Haek82: folds 
1nyyfan: folds 
wpcrso: calls $0.50
*** FLOP *** [8s 9s Jd]
wpcrso: bets $0.50
lamb1142: raises $0.50 to $1
wpcrso: calls $0.50
*** TURN *** [8s 9s Jd] [3s]
wpcrso: checks 
lamb1142: bets $1
wpcrso: calls $1
*** RIVER *** [8s 9s Jd 3s] [5c]
wpcrso: checks 
lamb1142: bets $1
wpcrso: calls $1
*** SHOW DOWN ***
lamb1142: shows [Qs Qd] (a pair of Queens)
wpcrso: mucks hand 
lamb1142 collected $8.35 from pot
*** SUMMARY ***
Total pot $8.75 | Rake $0.40 
Board [8s 9s Jd 3s 5c]
Seat 1: JMAC60 folded before Flop (didn't bet)
Seat 2: deepspace68 folded before Flop (didn't bet)
Seat 3: wpcrso mucked [Tc As]
Seat 4: Thumbber folded before Flop (didn't bet)
Seat 5: w.t. spartan folded before Flop (didn't bet)
Seat 6: ericlb111 folded before Flop (didn't bet)
Seat 7: lamb1142 showed [Qs Qd] and won ($8.35) with a pair of Queens
Seat 8: 1,1,2,3,5 (button) folded before Flop (didn't bet)
Seat 9: Haek82 (small blind) folded before Flop
Seat 10: 1nyyfan (big blind) folded before Flop



PokerStars Game #6808336280:  Hold'em Limit ($0.50/$1.00) - 2006/10/28 - 21:52:38 (ET)
Table 'Tanina' 10-max Seat #9 is the button
Seat 1: JMAC60 ($23.85 in chips) 
Seat 2: deepspace68 ($43.65 in chips) 
Seat 3: wpcrso ($18.10 in chips) 
Seat 4: Thumbber ($28.40 in chips) 
Seat 5: w.t. spartan ($10.95 in chips) 
Seat 6: ericlb111 ($19.25 in chips) 
Seat 7: lamb1142 ($34.25 in chips) 
Seat 8: 1,1,2,3,5 ($16.75 in chips) 
Seat 9: Haek82 ($28.55 in chips) 
Seat 10: 1nyyfan ($22.80 in chips) 
1nyyfan: posts small blind $0.25
JMAC60: posts big blind $0.50
*** HOLE CARDS ***
Dealt to 1,1,2,3,5 [Kd 3d]
deepspace68: folds 
wpcrso: folds 
Thumbber: folds 
w.t. spartan: folds 
deepspace68 leaves the table
Thumbber leaves the table
ericlb111: folds 
lamb1142: folds 
1,1,2,3,5: folds 
Haek82: raises $0.50 to $1
1nyyfan: calls $0.75
JMAC60: calls $0.50
*** FLOP *** [Tc Ad 4h]
1nyyfan: checks 
JMAC60: checks 
Haek82: bets $0.50
1nyyfan: calls $0.50
JMAC60: calls $0.50
*** TURN *** [Tc Ad 4h] [5d]
1nyyfan: checks 
JMAC60: checks 
Haek82: checks 
*** RIVER *** [Tc Ad 4h 5d] [3h]
1nyyfan: checks 
JMAC60: bets $1
Haek82: calls $1
1nyyfan: folds 
*** SHOW DOWN ***
JMAC60: shows [As 2c] (a straight, Ace to Five)
Haek82: mucks hand 
JMAC60 collected $6.20 from pot
*** SUMMARY ***
Total pot $6.50 | Rake $0.30 
Board [Tc Ad 4h 5d 3h]
Seat 1: JMAC60 (big blind) showed [As 2c] and won ($6.20) with a straight, Ace to Five
Seat 2: deepspace68 folded before Flop (didn't bet)
Seat 3: wpcrso folded before Flop (didn't bet)
Seat 4: Thumbber folded before Flop (didn't bet)
Seat 5: w.t. spartan folded before Flop (didn't bet)
Seat 6: ericlb111 folded before Flop (didn't bet)
Seat 7: lamb1142 folded before Flop (didn't bet)
Seat 8: 1,1,2,3,5 folded before Flop (didn't bet)
Seat 9: Haek82 (button) mucked [Jc Jh]
Seat 10: 1nyyfan (small blind) folded on the River



PokerStars Game #6808345429:  Hold'em Limit ($0.50/$1.00) - 2006/10/28 - 21:53:22 (ET)
Table 'Tanina' 10-max Seat #10 is the button
Seat 1: JMAC60 ($27.55 in chips) 
Seat 3: wpcrso ($18.10 in chips) 
Seat 5: w.t. spartan ($10.95 in chips) 
Seat 6: ericlb111 ($19.25 in chips) 
Seat 7: lamb1142 ($34.25 in chips) 
Seat 8: 1,1,2,3,5 ($16.75 in chips) 
Seat 9: Haek82 ($26.05 in chips) 
Seat 10: 1nyyfan ($21.30 in chips) 
JMAC60: posts small blind $0.25
wpcrso: posts big blind $0.50
*** HOLE CARDS ***
Dealt to 1,1,2,3,5 [Tc 7c]
w.t. spartan: folds 
ericlb111: calls $0.50
lamb1142: folds 
1,1,2,3,5: folds 
Haek82: folds 
1nyyfan: calls $0.50
JMAC60: folds 
wpcrso: checks 
*** FLOP *** [Td 3s Js]
wpcrso: checks 
ericlb111: checks 
1nyyfan: bets $0.50
wpcrso: calls $0.50
ericlb111: folds 
*** TURN *** [Td 3s Js] [Ks]
wpcrso: bets $1
1nyyfan: calls $1
*** RIVER *** [Td 3s Js Ks] [4s]
wpcrso: bets $1
1nyyfan: calls $1
*** SHOW DOWN ***
wpcrso: shows [Kd Qc] (a pair of Kings)
1nyyfan: shows [Kh Jh] (two pair, Kings and Jacks)
1nyyfan collected $6.45 from pot
*** SUMMARY ***
Total pot $6.75 | Rake $0.30 
Board [Td 3s Js Ks 4s]
Seat 1: JMAC60 (small blind) folded before Flop
Seat 3: wpcrso (big blind) showed [Kd Qc] and lost with a pair of Kings
Seat 5: w.t. spartan folded before Flop (didn't bet)
Seat 6: ericlb111 folded on the Flop
Seat 7: lamb1142 folded before Flop (didn't bet)
Seat 8: 1,1,2,3,5 folded before Flop (didn't bet)
Seat 9: Haek82 folded before Flop (didn't bet)
Seat 10: 1nyyfan (button) showed [Kh Jh] and won ($6.45) with two pair, Kings and Jacks



PokerStars Game #6808353515:  Hold'em Limit ($0.50/$1.00) - 2006/10/28 - 21:54:01 (ET)
Table 'Tanina' 10-max Seat #1 is the button
Seat 1: JMAC60 ($27.30 in chips) 
Seat 3: wpcrso ($15.10 in chips) 
Seat 5: w.t. spartan ($10.95 in chips) 
Seat 6: ericlb111 ($18.75 in chips) 
Seat 7: lamb1142 ($34.25 in chips) 
Seat 8: 1,1,2,3,5 ($16.75 in chips) 
Seat 9: Haek82 ($26.05 in chips) 
Seat 10: 1nyyfan ($24.75 in chips) 
wpcrso: posts small blind $0.25
w.t. spartan: posts big blind $0.50
*** HOLE CARDS ***
Dealt to 1,1,2,3,5 [Js Ad]
ericlb111: folds 
lamb1142: folds 
1,1,2,3,5: raises $0.50 to $1
Haek82: folds 
1nyyfan: folds 
JMAC60: folds 
wpcrso: folds 
w.t. spartan: calls $0.50
*** FLOP *** [6d 6s Tc]
w.t. spartan: checks 
1,1,2,3,5: checks 
*** TURN *** [6d 6s Tc] [Ts]
w.t. spartan: checks 
1,1,2,3,5: checks 
*** RIVER *** [6d 6s Tc Ts] [Qs]
w.t. spartan: checks 
1,1,2,3,5: bets $1
w.t. spartan: calls $1
*** SHOW DOWN ***
1,1,2,3,5: shows [Js Ad] (two pair, Tens and Sixes)
w.t. spartan: shows [As Jh] (two pair, Tens and Sixes)
w.t. spartan collected $2.05 from pot
1,1,2,3,5 collected $2 from pot
*** SUMMARY ***
Total pot $4.25 | Rake $0.20 
Board [6d 6s Tc Ts Qs]
Seat 1: JMAC60 (button) folded before Flop (didn't bet)
Seat 3: wpcrso (small blind) folded before Flop
Seat 5: w.t. spartan (big blind) showed [As Jh] and won ($2.05) with two pair, Tens and Sixes
Seat 6: ericlb111 folded before Flop (didn't bet)
Seat 7: lamb1142 folded before Flop (didn't bet)
Seat 8: 1,1,2,3,5 showed [Js Ad] and won ($2) with two pair, Tens and Sixes
Seat 9: Haek82 folded before Flop (didn't bet)
Seat 10: 1nyyfan folded before Flop (didn't bet)



PokerStars Game #6808360973:  Hold'em Limit ($0.50/$1.00) - 2006/10/28 - 21:54:37 (ET)
Table 'Tanina' 10-max Seat #3 is the button
Seat 1: JMAC60 ($27.30 in chips) 
Seat 3: wpcrso ($14.85 in chips) 
Seat 5: w.t. spartan ($11 in chips) 
Seat 7: lamb1142 ($34.25 in chips) 
Seat 8: 1,1,2,3,5 ($16.75 in chips) 
Seat 9: Haek82 ($26.05 in chips) 
Seat 10: 1nyyfan ($24.75 in chips) 
w.t. spartan: posts small blind $0.25
ericlb111: is sitting out 
lamb1142: posts big blind $0.50
*** HOLE CARDS ***
Dealt to 1,1,2,3,5 [2h Jc]
1,1,2,3,5: folds 
Haek82: folds 
1nyyfan: calls $0.50
JMAC60: folds 
wpcrso: folds 
w.t. spartan: calls $0.25
lamb1142: checks 
*** FLOP *** [Kc 3h Qc]
w.t. spartan: checks 
lamb1142: checks 
1nyyfan: bets $0.50
w.t. spartan: folds 
lamb1142: folds 
1nyyfan collected $1.45 from pot
1nyyfan: doesn't show hand 
*** SUMMARY ***
Total pot $1.50 | Rake $0.05 
Board [Kc 3h Qc]
Seat 1: JMAC60 folded before Flop (didn't bet)
Seat 3: wpcrso (button) folded before Flop (didn't bet)
Seat 5: w.t. spartan (small blind) folded on the Flop
Seat 7: lamb1142 (big blind) folded on the Flop
Seat 8: 1,1,2,3,5 folded before Flop (didn't bet)
Seat 9: Haek82 folded before Flop (didn't bet)
Seat 10: 1nyyfan collected ($1.45)



PokerStars Game #6808367237:  Hold'em Limit ($0.50/$1.00) - 2006/10/28 - 21:55:07 (ET)
Table 'Tanina' 10-max Seat #5 is the button
Seat 1: JMAC60 ($27.30 in chips) 
Seat 3: wpcrso ($14.85 in chips) 
Seat 5: w.t. spartan ($10.50 in chips) 
Seat 7: lamb1142 ($33.75 in chips) 
Seat 8: 1,1,2,3,5 ($16.75 in chips) 
Seat 9: Haek82 ($26.05 in chips) 
Seat 10: 1nyyfan ($25.70 in chips) 
lamb1142: posts small blind $0.25
1,1,2,3,5: posts big blind $0.50
*** HOLE CARDS ***
Dealt to 1,1,2,3,5 [9h 5h]
Haek82: folds 
1nyyfan: calls $0.50
JMAC60: folds 
wpcrso: folds 
w.t. spartan: calls $0.50
ericlb111 leaves the table
lamb1142: calls $0.25
1,1,2,3,5: checks 
*** FLOP *** [2d 3h Td]
lamb1142: checks 
1,1,2,3,5: checks 
1nyyfan: checks 
w.t. spartan: checks 
*** TURN *** [2d 3h Td] [Qd]
lamb1142: checks 
1,1,2,3,5: checks 
1nyyfan: checks 
w.t. spartan: checks 
*** RIVER *** [2d 3h Td Qd] [5d]
lamb1142: checks 
1,1,2,3,5: checks 
1nyyfan: checks 
w.t. spartan: checks 
*** SHOW DOWN ***
lamb1142: shows [9s 7s] (high card Queen)
1,1,2,3,5: shows [9h 5h] (a pair of Fives)
1nyyfan: shows [Qs Kc] (a pair of Queens)
w.t. spartan: shows [8d 7h] (a flush, Queen high)
w.t. spartan collected $1.90 from pot
*** SUMMARY ***
Total pot $2 | Rake $0.10 
Board [2d 3h Td Qd 5d]
Seat 1: JMAC60 folded before Flop (didn't bet)
Seat 3: wpcrso folded before Flop (didn't bet)
Seat 5: w.t. spartan (button) showed [8d 7h] and won ($1.90) with a flush, Queen high
Seat 7: lamb1142 (small blind) showed [9s 7s] and lost with high card Queen
Seat 8: 1,1,2,3,5 (big blind) showed [9h 5h] and lost with a pair of Fives
Seat 9: Haek82 folded before Flop (didn't bet)
Seat 10: 1nyyfan showed [Qs Kc] and lost with a pair of Queens



PokerStars Game #6808375285:  Hold'em Limit ($0.50/$1.00) - 2006/10/28 - 21:55:46 (ET)
Table 'Tanina' 10-max Seat #7 is the button
Seat 1: JMAC60 ($27.30 in chips) 
Seat 3: wpcrso ($14.85 in chips) 
Seat 5: w.t. spartan ($11.90 in chips) 
Seat 7: lamb1142 ($33.25 in chips) 
Seat 8: 1,1,2,3,5 ($16.25 in chips) 
Seat 9: Haek82 ($26.05 in chips) 
Seat 10: 1nyyfan ($25.20 in chips) 
1,1,2,3,5: posts small blind $0.25
Haek82: posts big blind $0.50
*** HOLE CARDS ***
Dealt to 1,1,2,3,5 [Js Kd]
1nyyfan: folds 
JMAC60: folds 
wpcrso: raises $0.50 to $1
w.t. spartan: folds 
lamb1142: folds 
1,1,2,3,5: folds 
Haek82: folds 
wpcrso collected $1.25 from pot
wpcrso: doesn't show hand 
*** SUMMARY ***
Total pot $1.25 | Rake $0 
Seat 1: JMAC60 folded before Flop (didn't bet)
Seat 3: wpcrso collected ($1.25)
Seat 5: w.t. spartan folded before Flop (didn't bet)
Seat 7: lamb1142 (button) folded before Flop (didn't bet)
Seat 8: 1,1,2,3,5 (small blind) folded before Flop
Seat 9: Haek82 (big blind) folded before Flop
Seat 10: 1nyyfan folded before Flop (didn't bet)



PokerStars Game #6808379841:  Hold'em Limit ($0.50/$1.00) - 2006/10/28 - 21:56:08 (ET)
Table 'Tanina' 10-max Seat #8 is the button
Seat 1: JMAC60 ($27.30 in chips) 
Seat 3: wpcrso ($15.60 in chips) 
Seat 5: w.t. spartan ($11.90 in chips) 
Seat 7: lamb1142 ($33.25 in chips) 
Seat 8: 1,1,2,3,5 ($16 in chips) 
Seat 9: Haek82 ($25.55 in chips) 
Seat 10: 1nyyfan ($25.20 in chips) 
Haek82: posts small blind $0.25
1nyyfan: posts big blind $0.50
*** HOLE CARDS ***
Dealt to 1,1,2,3,5 [3c Ts]
JMAC60: folds 
wpcrso: folds 
w.t. spartan: raises $0.50 to $1
lamb1142: folds 
1,1,2,3,5: folds 
Haek82: folds 
1nyyfan: calls $0.50
*** FLOP *** [Td 9h Kc]
1nyyfan: checks 
w.t. spartan: bets $0.50
1nyyfan: folds 
w.t. spartan collected $2.15 from pot
*** SUMMARY ***
Total pot $2.25 | Rake $0.10 
Board [Td 9h Kc]
Seat 1: JMAC60 folded before Flop (didn't bet)
Seat 3: wpcrso folded before Flop (didn't bet)
Seat 5: w.t. spartan collected ($2.15)
Seat 7: lamb1142 folded before Flop (didn't bet)
Seat 8: 1,1,2,3,5 (button) folded before Flop (didn't bet)
Seat 9: Haek82 (small blind) folded before Flop
Seat 10: 1nyyfan (big blind) folded on the Flop



PokerStars Game #6808384291:  Hold'em Limit ($0.50/$1.00) - 2006/10/28 - 21:56:29 (ET)
Table 'Tanina' 10-max Seat #9 is the button
Seat 1: JMAC60 ($27.30 in chips) 
Seat 3: wpcrso ($15.60 in chips) 
Seat 5: w.t. spartan ($13.05 in chips) 
Seat 7: lamb1142 ($33.25 in chips) 
Seat 8: 1,1,2,3,5 ($16 in chips) 
Seat 9: Haek82 ($25.30 in chips) 
Seat 10: 1nyyfan ($24.20 in chips) 
1nyyfan: posts small blind $0.25
JMAC60: posts big blind $0.50
*** HOLE CARDS ***
Dealt to 1,1,2,3,5 [Ac 8h]
wpcrso: folds 
w.t. spartan: folds 
lamb1142: folds 
1,1,2,3,5: folds 
Haek82: raises $0.50 to $1
1nyyfan: folds 
JMAC60: folds 
Haek82 collected $1.25 from pot
*** SUMMARY ***
Total pot $1.25 | Rake $0 
Seat 1: JMAC60 (big blind) folded before Flop
Seat 3: wpcrso folded before Flop (didn't bet)
Seat 5: w.t. spartan folded before Flop (didn't bet)
Seat 7: lamb1142 folded before Flop (didn't bet)
Seat 8: 1,1,2,3,5 folded before Flop (didn't bet)
Seat 9: Haek82 (button) collected ($1.25)
Seat 10: 1nyyfan (small blind) folded before Flop



PokerStars Game #6808387416:  Hold'em Limit ($0.50/$1.00) - 2006/10/28 - 21:56:45 (ET)
Table 'Tanina' 10-max Seat #10 is the button
Seat 1: JMAC60 ($26.80 in chips) 
Seat 3: wpcrso ($15.60 in chips) 
Seat 5: w.t. spartan ($13.05 in chips) 
Seat 7: lamb1142 ($33.25 in chips) 
Seat 8: 1,1,2,3,5 ($16 in chips) 
Seat 9: Haek82 ($26.05 in chips) 
Seat 10: 1nyyfan ($23.95 in chips) 
JMAC60: posts small blind $0.25
wpcrso: posts big blind $0.50
*** HOLE CARDS ***
Dealt to 1,1,2,3,5 [6d 8c]
w.t. spartan: folds 
lamb1142: folds 
1,1,2,3,5: folds 
Haek82: folds 
1nyyfan: folds 
JMAC60: raises $0.50 to $1
wpcrso: calls $0.50
*** FLOP *** [5h 2d 4s]
outflushed2 joins the table at seat #6 
JMAC60: bets $0.50
wpcrso: calls $0.50
*** TURN *** [5h 2d 4s] [Th]
JMAC60: bets $1
wpcrso: calls $1
*** RIVER *** [5h 2d 4s Th] [4h]
JMAC60: bets $1
wpcrso: calls $1
*** SHOW DOWN ***
JMAC60: shows [9c Qh] (a pair of Fours)
wpcrso: shows [Ts As] (two pair, Tens and Fours)
wpcrso collected $6.70 from pot
*** SUMMARY ***
Total pot $7 | Rake $0.30 
Board [5h 2d 4s Th 4h]
Seat 1: JMAC60 (small blind) showed [9c Qh] and lost with a pair of Fours
Seat 3: wpcrso (big blind) showed [Ts As] and won ($6.70) with two pair, Tens and Fours
Seat 5: w.t. spartan folded before Flop (didn't bet)
Seat 7: lamb1142 folded before Flop (didn't bet)
Seat 8: 1,1,2,3,5 folded before Flop (didn't bet)
Seat 9: Haek82 folded before Flop (didn't bet)
Seat 10: 1nyyfan (button) folded before Flop (didn't bet)



PokerStars Game #6808395223:  Hold'em Limit ($0.50/$1.00) - 2006/10/28 - 21:57:22 (ET)
Table 'Tanina' 10-max Seat #1 is the button
Seat 1: JMAC60 ($23.30 in chips) 
Seat 3: wpcrso ($18.80 in chips) 
Seat 5: w.t. spartan ($13.05 in chips) 
Seat 7: lamb1142 ($33.25 in chips) 
Seat 8: 1,1,2,3,5 ($16 in chips) 
Seat 9: Haek82 ($26.05 in chips) 
Seat 10: 1nyyfan ($23.95 in chips) 
wpcrso: posts small blind $0.25
w.t. spartan: posts big blind $0.50
outflushed2: sits out 
*** HOLE CARDS ***
Dealt to 1,1,2,3,5 [Qd 4h]
lamb1142: calls $0.50
1,1,2,3,5: folds 
Haek82: calls $0.50
1nyyfan: folds 
JMAC60: calls $0.50
wpcrso: calls $0.25
w.t. spartan: checks 
*** FLOP *** [Kc 9d 4c]
wpcrso: checks 
w.t. spartan: checks 
lamb1142: bets $0.50
Haek82: calls $0.50
JMAC60: folds 
wpcrso: folds 
w.t. spartan: folds 
*** TURN *** [Kc 9d 4c] [8d]
lamb1142: bets $1
Haek82: calls $1
*** RIVER *** [Kc 9d 4c 8d] [6c]
lamb1142: bets $1
Haek82: calls $1
*** SHOW DOWN ***
lamb1142: shows [Ah 9h] (a pair of Nines)
Haek82: shows [Kd Tc] (a pair of Kings)
Haek82 collected $7.15 from pot
*** SUMMARY ***
Total pot $7.50 | Rake $0.35 
Board [Kc 9d 4c 8d 6c]
Seat 1: JMAC60 (button) folded on the Flop
Seat 3: wpcrso (small blind) folded on the Flop
Seat 5: w.t. spartan (big blind) folded on the Flop
Seat 7: lamb1142 showed [Ah 9h] and lost with a pair of Nines
Seat 8: 1,1,2,3,5 folded before Flop (didn't bet)
Seat 9: Haek82 showed [Kd Tc] and won ($7.15) with a pair of Kings
Seat 10: 1nyyfan folded before Flop (didn't bet)



PokerStars Game #6808402781:  Hold'em Limit ($0.50/$1.00) - 2006/10/28 - 21:57:59 (ET)
Table 'Tanina' 10-max Seat #3 is the button
Seat 1: JMAC60 ($22.80 in chips) 
Seat 3: wpcrso ($18.30 in chips) 
Seat 5: w.t. spartan ($12.55 in chips) 
Seat 6: outflushed2 ($20 in chips) 
Seat 7: lamb1142 ($30.25 in chips) 
Seat 8: 1,1,2,3,5 ($16 in chips) 
Seat 9: Haek82 ($30.20 in chips) 
Seat 10: 1nyyfan ($23.95 in chips) 
w.t. spartan: posts small blind $0.25
outflushed2: posts big blind $0.50
*** HOLE CARDS ***
Dealt to 1,1,2,3,5 [Kh Js]
lamb1142: calls $0.50
1,1,2,3,5: folds 
Haek82: folds 
1nyyfan: folds 
JMAC60: folds 
wpcrso: folds 
w.t. spartan: calls $0.25
outflushed2: checks 
*** FLOP *** [Jc 2h Qs]
w.t. spartan: checks 
outflushed2: bets $0.50
lamb1142: calls $0.50
w.t. spartan: folds 
*** TURN *** [Jc 2h Qs] [7c]
outflushed2: bets $1
lamb1142: calls $1
*** RIVER *** [Jc 2h Qs 7c] [Tc]
outflushed2: bets $1
lamb1142: calls $1
*** SHOW DOWN ***
outflushed2: shows [2d Qh] (two pair, Queens and Deuces)
lamb1142: mucks hand 
outflushed2 collected $6.20 from pot
*** SUMMARY ***
Total pot $6.50 | Rake $0.30 
Board [Jc 2h Qs 7c Tc]
Seat 1: JMAC60 folded before Flop (didn't bet)
Seat 3: wpcrso (button) folded before Flop (didn't bet)
Seat 5: w.t. spartan (small blind) folded on the Flop
Seat 6: outflushed2 (big blind) showed [2d Qh] and won ($6.20) with two pair, Queens and Deuces
Seat 7: lamb1142 mucked [Th Ah]
Seat 8: 1,1,2,3,5 folded before Flop (didn't bet)
Seat 9: Haek82 folded before Flop (didn't bet)
Seat 10: 1nyyfan folded before Flop (didn't bet)



PokerStars Game #6808411638:  Hold'em Limit ($0.50/$1.00) - 2006/10/28 - 21:58:41 (ET)
Table 'Tanina' 10-max Seat #5 is the button
Seat 1: JMAC60 ($22.80 in chips) 
Seat 3: wpcrso ($18.30 in chips) 
Seat 5: w.t. spartan ($12.05 in chips) 
Seat 6: outflushed2 ($23.20 in chips) 
Seat 8: 1,1,2,3,5 ($16 in chips) 
Seat 9: Haek82 ($30.20 in chips) 
Seat 10: 1nyyfan ($23.95 in chips) 
outflushed2: posts small blind $0.25
lamb1142: is sitting out 
1,1,2,3,5: posts big blind $0.50
*** HOLE CARDS ***
Dealt to 1,1,2,3,5 [8d 8s]
Haek82: folds 
1nyyfan: folds 
JMAC60: folds 
wpcrso: raises $0.50 to $1
w.t. spartan: folds 
outflushed2: folds 
1,1,2,3,5: calls $0.50
*** FLOP *** [Qd Ac 5s]
1,1,2,3,5: checks 
wpcrso: bets $0.50
1,1,2,3,5: folds 
Gerryc009 joins the table at seat #4 
wpcrso collected $2.15 from pot
wpcrso: doesn't show hand 
*** SUMMARY ***
Total pot $2.25 | Rake $0.10 
Board [Qd Ac 5s]
Seat 1: JMAC60 folded before Flop (didn't bet)
Seat 3: wpcrso collected ($2.15)
Seat 5: w.t. spartan (button) folded before Flop (didn't bet)
Seat 6: outflushed2 (small blind) folded before Flop
Seat 8: 1,1,2,3,5 (big blind) folded on the Flop
Seat 9: Haek82 folded before Flop (didn't bet)
Seat 10: 1nyyfan folded before Flop (didn't bet)



PokerStars Game #6808416920:  Hold'em Limit ($0.50/$1.00) - 2006/10/28 - 21:59:06 (ET)
Table 'Tanina' 10-max Seat #6 is the button
Seat 1: JMAC60 ($22.80 in chips) 
Seat 3: wpcrso ($19.45 in chips) 
Seat 4: Gerryc009 ($20 in chips) 
Seat 5: w.t. spartan ($12.05 in chips) 
Seat 6: outflushed2 ($22.95 in chips) 
Seat 8: 1,1,2,3,5 ($15 in chips) 
Seat 9: Haek82 ($30.20 in chips) 
Seat 10: 1nyyfan ($23.95 in chips) 
1,1,2,3,5: posts small blind $0.25
Haek82: posts big blind $0.50
Gerryc009: posts big blind $0.50
*** HOLE CARDS ***
Dealt to 1,1,2,3,5 [5h Kd]
1nyyfan: folds 
JMAC60: folds 
wpcrso: calls $0.50
Gerryc009: checks 
w.t. spartan: folds 
outflushed2: folds 
1,1,2,3,5: calls $0.25
Haek82: checks 
*** FLOP *** [3s 3c 4h]
1,1,2,3,5: checks 
Moooose joins the table at seat #2 
Haek82: checks 
wpcrso: checks 
Gerryc009: checks 
*** TURN *** [3s 3c 4h] [Ah]
1,1,2,3,5: checks 
Haek82: checks 
wpcrso: checks 
Gerryc009: checks 
*** RIVER *** [3s 3c 4h Ah] [2d]
1,1,2,3,5: bets $1
Haek82: folds 
wpcrso: folds 
Gerryc009: folds 
1,1,2,3,5 collected $1.90 from pot
1,1,2,3,5: doesn't show hand 
*** SUMMARY ***
Total pot $2 | Rake $0.10 
Board [3s 3c 4h Ah 2d]
Seat 1: JMAC60 folded before Flop (didn't bet)
Seat 3: wpcrso folded on the River
Seat 4: Gerryc009 folded on the River
Seat 5: w.t. spartan folded before Flop (didn't bet)
Seat 6: outflushed2 (button) folded before Flop (didn't bet)
Seat 8: 1,1,2,3,5 (small blind) collected ($1.90)
Seat 9: Haek82 (big blind) folded on the River
Seat 10: 1nyyfan folded before Flop (didn't bet)



PokerStars Game #6808427453:  Hold'em Limit ($0.50/$1.00) - 2006/10/28 - 21:59:57 (ET)
Table 'Tanina' 10-max Seat #8 is the button
Seat 1: JMAC60 ($22.80 in chips) 
Seat 3: wpcrso ($18.95 in chips) 
Seat 4: Gerryc009 ($19.50 in chips) 
Seat 5: w.t. spartan ($12.05 in chips) 
Seat 6: outflushed2 ($22.95 in chips) 
Seat 8: 1,1,2,3,5 ($16.40 in chips) 
Seat 9: Haek82 ($29.70 in chips) 
Seat 10: 1nyyfan ($23.95 in chips) 
Haek82: posts small blind $0.25
1nyyfan: posts big blind $0.50
Moooose: sits out 
*** HOLE CARDS ***
Dealt to 1,1,2,3,5 [2h 8c]
JMAC60: folds 
wpcrso: folds 
Gerryc009: calls $0.50
w.t. spartan: folds 
outflushed2: folds 
1,1,2,3,5: folds 
Haek82: folds 
1nyyfan: checks 
*** FLOP *** [Qc 6s 6c]
1nyyfan: checks 
Gerryc009: checks 
*** TURN *** [Qc 6s 6c] [9c]
1nyyfan: checks 
Gerryc009: bets $1
1nyyfan: calls $1
*** RIVER *** [Qc 6s 6c 9c] [Ad]
1nyyfan: checks 
Gerryc009: bets $1
1nyyfan: calls $1
*** SHOW DOWN ***
Gerryc009: shows [4d 9d] (two pair, Nines and Sixes)
1nyyfan: shows [4h Qs] (two pair, Queens and Sixes)
1nyyfan collected $5 from pot
*** SUMMARY ***
Total pot $5.25 | Rake $0.25 
Board [Qc 6s 6c 9c Ad]
Seat 1: JMAC60 folded before Flop (didn't bet)
Seat 3: wpcrso folded before Flop (didn't bet)
Seat 4: Gerryc009 showed [4d 9d] and lost with two pair, Nines and Sixes
Seat 5: w.t. spartan folded before Flop (didn't bet)
Seat 6: outflushed2 folded before Flop (didn't bet)
Seat 8: 1,1,2,3,5 (button) folded before Flop (didn't bet)
Seat 9: Haek82 (small blind) folded before Flop
Seat 10: 1nyyfan (big blind) showed [4h Qs] and won ($5) with two pair, Queens and Sixes



PokerStars Game #6808435034:  Hold'em Limit ($0.50/$1.00) - 2006/10/28 - 22:00:32 (ET)
Table 'Tanina' 10-max Seat #9 is the button
Seat 1: JMAC60 ($22.80 in chips) 
Seat 3: wpcrso ($18.95 in chips) 
Seat 4: Gerryc009 ($17 in chips) 
Seat 5: w.t. spartan ($12.05 in chips) 
Seat 6: outflushed2 ($22.95 in chips) 
Seat 8: 1,1,2,3,5 ($16.40 in chips) 
Seat 9: Haek82 ($29.45 in chips) 
Seat 10: 1nyyfan ($26.45 in chips) 
1nyyfan: posts small blind $0.25
JMAC60: posts big blind $0.50
Moooose: sits out 
*** HOLE CARDS ***
Dealt to 1,1,2,3,5 [Tc Ad]
wpcrso: folds 
lamb1142 has returned
Gerryc009: calls $0.50
w.t. spartan: folds 
outflushed2: folds 
1,1,2,3,5: calls $0.50
Haek82: folds 
1nyyfan: calls $0.25
JMAC60: checks 
*** FLOP *** [Th Kc 3h]
1nyyfan: checks 
JMAC60: checks 
Gerryc009: bets $0.50
1,1,2,3,5: calls $0.50
1nyyfan: folds 
JMAC60: folds 
*** TURN *** [Th Kc 3h] [3d]
Gerryc009: checks 
1,1,2,3,5: checks 
*** RIVER *** [Th Kc 3h 3d] [6s]
Gerryc009: checks 
1,1,2,3,5: checks 
*** SHOW DOWN ***
Gerryc009: shows [Qs 9c] (a pair of Threes)
1,1,2,3,5: shows [Tc Ad] (two pair, Tens and Threes)
1,1,2,3,5 collected $2.90 from pot
*** SUMMARY ***
Total pot $3 | Rake $0.10 
Board [Th Kc 3h 3d 6s]
Seat 1: JMAC60 (big blind) folded on the Flop
Seat 3: wpcrso folded before Flop (didn't bet)
Seat 4: Gerryc009 showed [Qs 9c] and lost with a pair of Threes
Seat 5: w.t. spartan folded before Flop (didn't bet)
Seat 6: outflushed2 folded before Flop (didn't bet)
Seat 8: 1,1,2,3,5 showed [Tc Ad] and won ($2.90) with two pair, Tens and Threes
Seat 9: Haek82 (button) folded before Flop (didn't bet)
Seat 10: 1nyyfan (small blind) folded on the Flop



PokerStars Game #6808444597:  Hold'em Limit ($0.50/$1.00) - 2006/10/28 - 22:01:19 (ET)
Table 'Tanina' 10-max Seat #10 is the button
Seat 1: JMAC60 ($22.30 in chips) 
Seat 2: Moooose ($23 in chips) 
Seat 3: wpcrso ($18.95 in chips) 
Seat 4: Gerryc009 ($16 in chips) 
Seat 5: w.t. spartan ($12.05 in chips) 
Seat 6: outflushed2 ($22.95 in chips) 
Seat 8: 1,1,2,3,5 ($18.30 in chips) 
Seat 9: Haek82 ($29.45 in chips) 
Seat 10: 1nyyfan ($25.95 in chips) 
JMAC60: posts small blind $0.25
Moooose: posts big blind $0.50
lamb1142: sits out 
*** HOLE CARDS ***
Dealt to 1,1,2,3,5 [9d Js]
wpcrso: folds 
Gerryc009: folds 
w.t. spartan: folds 
outflushed2: raises $0.50 to $1
1,1,2,3,5: folds 
Haek82: raises $0.50 to $1.50
1nyyfan: folds 
JMAC60: folds 
Moooose: folds 
outflushed2: raises $0.50 to $2
Betting is capped
Haek82: calls $0.50
*** FLOP *** [2d 8h 2h]
outflushed2: bets $0.50
Haek82: calls $0.50
*** TURN *** [2d 8h 2h] [Qh]
outflushed2: bets $1
Haek82: calls $1
*** RIVER *** [2d 8h 2h Qh] [Ac]
outflushed2: checks 
Haek82: bets $1
outflushed2: calls $1
*** SHOW DOWN ***
Haek82: shows [Ad Jd] (two pair, Aces and Deuces)
outflushed2: mucks hand 
Haek82 collected $9.30 from pot
*** SUMMARY ***
Total pot $9.75 | Rake $0.45 
Board [2d 8h 2h Qh Ac]
Seat 1: JMAC60 (small blind) folded before Flop
Seat 2: Moooose (big blind) folded before Flop
Seat 3: wpcrso folded before Flop (didn't bet)
Seat 4: Gerryc009 folded before Flop (didn't bet)
Seat 5: w.t. spartan folded before Flop (didn't bet)
Seat 6: outflushed2 mucked [Ks Kd]
Seat 8: 1,1,2,3,5 folded before Flop (didn't bet)
Seat 9: Haek82 showed [Ad Jd] and won ($9.30) with two pair, Aces and Deuces
Seat 10: 1nyyfan (button) folded before Flop (didn't bet)



PokerStars Game #6808452767:  Hold'em Limit ($0.50/$1.00) - 2006/10/28 - 22:01:58 (ET)
Table 'Tanina' 10-max Seat #1 is the button
Seat 1: JMAC60 ($22.05 in chips) 
Seat 2: Moooose ($22.50 in chips) 
Seat 3: wpcrso ($18.95 in chips) 
Seat 4: Gerryc009 ($16 in chips) 
Seat 5: w.t. spartan ($12.05 in chips) 
Seat 6: outflushed2 ($18.45 in chips) 
Seat 8: 1,1,2,3,5 ($18.30 in chips) 
Seat 9: Haek82 ($34.25 in chips) 
Seat 10: 1nyyfan ($25.95 in chips) 
Moooose: posts small blind $0.25
wpcrso: posts big blind $0.50
lamb1142: sits out 
*** HOLE CARDS ***
Dealt to 1,1,2,3,5 [4c 2s]
Gerryc009: calls $0.50
w.t. spartan: folds 
outflushed2: folds 
1,1,2,3,5: folds 
Haek82: calls $0.50
1nyyfan: folds 
JMAC60: folds 
Moooose: calls $0.25
wpcrso: checks 
*** FLOP *** [6s Kc 2d]
Moooose: checks 
wpcrso: checks 
Gerryc009: checks 
Haek82: bets $0.50
Moooose: folds 
wpcrso: folds 
Gerryc009: calls $0.50
*** TURN *** [6s Kc 2d] [2h]
Gerryc009: checks 
Haek82: checks 
*** RIVER *** [6s Kc 2d 2h] [3s]
Gerryc009: checks 
Haek82: bets $1
Gerryc009: calls $1
*** SHOW DOWN ***
Haek82: shows [9d Td] (a pair of Deuces)
Gerryc009: shows [3d 6d] (two pair, Sixes and Threes)
Gerryc009 collected $4.80 from pot
*** SUMMARY ***
Total pot $5 | Rake $0.20 
Board [6s Kc 2d 2h 3s]
Seat 1: JMAC60 (button) folded before Flop (didn't bet)
Seat 2: Moooose (small blind) folded on the Flop
Seat 3: wpcrso (big blind) folded on the Flop
Seat 4: Gerryc009 showed [3d 6d] and won ($4.80) with two pair, Sixes and Threes
Seat 5: w.t. spartan folded before Flop (didn't bet)
Seat 6: outflushed2 folded before Flop (didn't bet)
Seat 8: 1,1,2,3,5 folded before Flop (didn't bet)
Seat 9: Haek82 showed [9d Td] and lost with a pair of Deuces
Seat 10: 1nyyfan folded before Flop (didn't bet)



PokerStars Game #6808463279:  Hold'em Limit ($0.50/$1.00) - 2006/10/28 - 22:02:48 (ET)
Table 'Tanina' 10-max Seat #2 is the button
Seat 1: JMAC60 ($22.05 in chips) 
Seat 2: Moooose ($22 in chips) 
Seat 3: wpcrso ($18.45 in chips) 
Seat 4: Gerryc009 ($18.80 in chips) 
Seat 5: w.t. spartan ($12.05 in chips) 
Seat 6: outflushed2 ($18.45 in chips) 
Seat 8: 1,1,2,3,5 ($18.30 in chips) 
Seat 9: Haek82 ($32.25 in chips) 
Seat 10: 1nyyfan ($25.95 in chips) 
wpcrso: posts small blind $0.25
Gerryc009: posts big blind $0.50
lamb1142: sits out 
*** HOLE CARDS ***
Dealt to 1,1,2,3,5 [Jc 4d]
w.t. spartan: folds 
outflushed2: folds 
1,1,2,3,5: folds 
Haek82: folds 
1nyyfan: folds 
JMAC60: folds 
Moooose: folds 
wpcrso: raises $0.50 to $1
Gerryc009: calls $0.50
*** FLOP *** [Qd 5d 8s]
wpcrso: bets $0.50
Gerryc009: folds 
wpcrso collected $1.90 from pot
wpcrso: doesn't show hand 
*** SUMMARY ***
Total pot $2 | Rake $0.10 
Board [Qd 5d 8s]
Seat 1: JMAC60 folded before Flop (didn't bet)
Seat 2: Moooose (button) folded before Flop (didn't bet)
Seat 3: wpcrso (small blind) collected ($1.90)
Seat 4: Gerryc009 (big blind) folded on the Flop
Seat 5: w.t. spartan folded before Flop (didn't bet)
Seat 6: outflushed2 folded before Flop (didn't bet)
Seat 8: 1,1,2,3,5 folded before Flop (didn't bet)
Seat 9: Haek82 folded before Flop (didn't bet)
Seat 10: 1nyyfan folded before Flop (didn't bet)



PokerStars Game #6808468702:  Hold'em Limit ($0.50/$1.00) - 2006/10/28 - 22:03:14 (ET)
Table 'Tanina' 10-max Seat #3 is the button
Seat 1: JMAC60 ($22.05 in chips) 
Seat 2: Moooose ($22 in chips) 
Seat 3: wpcrso ($19.35 in chips) 
Seat 4: Gerryc009 ($17.80 in chips) 
Seat 5: w.t. spartan ($12.05 in chips) 
Seat 6: outflushed2 ($18.45 in chips) 
Seat 8: 1,1,2,3,5 ($18.30 in chips) 
Seat 9: Haek82 ($32.25 in chips) 
Seat 10: 1nyyfan ($25.95 in chips) 
Gerryc009: posts small blind $0.25
w.t. spartan: posts big blind $0.50
lamb1142: sits out 
*** HOLE CARDS ***
Dealt to 1,1,2,3,5 [As Qh]
outflushed2: folds 
1,1,2,3,5: raises $0.50 to $1
Haek82: folds 
1nyyfan: folds 
JMAC60: folds 
Moooose: folds 
wpcrso: folds 
Gerryc009: calls $0.75
w.t. spartan: folds 
*** FLOP *** [7d 5s 9d]
Gerryc009: checks 
1,1,2,3,5: checks 
*** TURN *** [7d 5s 9d] [7h]
Gerryc009: checks 
1,1,2,3,5: checks 
*** RIVER *** [7d 5s 9d 7h] [Th]
Gerryc009: checks 
1,1,2,3,5: checks 
*** SHOW DOWN ***
Gerryc009: shows [4h Qc] (a pair of Sevens)
1,1,2,3,5: shows [As Qh] (a pair of Sevens - Ace kicker)
1,1,2,3,5 collected $2.40 from pot
*** SUMMARY ***
Total pot $2.50 | Rake $0.10 
Board [7d 5s 9d 7h Th]
Seat 1: JMAC60 folded before Flop (didn't bet)
Seat 2: Moooose folded before Flop (didn't bet)
Seat 3: wpcrso (button) folded before Flop (didn't bet)
Seat 4: Gerryc009 (small blind) showed [4h Qc] and lost with a pair of Sevens
Seat 5: w.t. spartan (big blind) folded before Flop
Seat 6: outflushed2 folded before Flop (didn't bet)
Seat 8: 1,1,2,3,5 showed [As Qh] and won ($2.40) with a pair of Sevens
Seat 9: Haek82 folded before Flop (didn't bet)
Seat 10: 1nyyfan folded before Flop (didn't bet)



PokerStars Game #6808477228:  Hold'em Limit ($0.50/$1.00) - 2006/10/28 - 22:03:55 (ET)
Table 'Tanina' 10-max Seat #4 is the button
Seat 1: JMAC60 ($22.05 in chips) 
Seat 2: Moooose ($22 in chips) 
Seat 3: wpcrso ($19.35 in chips) 
Seat 4: Gerryc009 ($16.80 in chips) 
Seat 5: w.t. spartan ($11.55 in chips) 
Seat 6: outflushed2 ($18.45 in chips) 
Seat 8: 1,1,2,3,5 ($19.70 in chips) 
Seat 9: Haek82 ($32.25 in chips) 
Seat 10: 1nyyfan ($25.95 in chips) 
w.t. spartan: posts small blind $0.25
outflushed2: posts big blind $0.50
lamb1142: sits out 
*** HOLE CARDS ***
Dealt to 1,1,2,3,5 [8c 6c]
1,1,2,3,5: folds 
Haek82: raises $0.50 to $1
1nyyfan: folds 
JMAC60: folds 
Moooose: folds 
wpcrso: folds 
Gerryc009: folds 
w.t. spartan: calls $0.75
outflushed2: folds 
*** FLOP *** [3h Th Jc]
w.t. spartan: checks 
Haek82: bets $0.50
w.t. spartan: calls $0.50
*** TURN *** [3h Th Jc] [8d]
w.t. spartan: checks 
Haek82: bets $1
w.t. spartan: calls $1
*** RIVER *** [3h Th Jc 8d] [2c]
w.t. spartan: checks 
Haek82: checks 
*** SHOW DOWN ***
w.t. spartan: shows [8s 7d] (a pair of Eights)
Haek82: mucks hand 
w.t. spartan collected $5.25 from pot
*** SUMMARY ***
Total pot $5.50 | Rake $0.25 
Board [3h Th Jc 8d 2c]
Seat 1: JMAC60 folded before Flop (didn't bet)
Seat 2: Moooose folded before Flop (didn't bet)
Seat 3: wpcrso folded before Flop (didn't bet)
Seat 4: Gerryc009 (button) folded before Flop (didn't bet)
Seat 5: w.t. spartan (small blind) showed [8s 7d] and won ($5.25) with a pair of Eights
Seat 6: outflushed2 (big blind) folded before Flop
Seat 8: 1,1,2,3,5 folded before Flop (didn't bet)
Seat 9: Haek82 mucked [6d 9d]
Seat 10: 1nyyfan folded before Flop (didn't bet)



PokerStars Game #6808485679:  Hold'em Limit ($0.50/$1.00) - 2006/10/28 - 22:04:35 (ET)
Table 'Tanina' 10-max Seat #5 is the button
Seat 1: JMAC60 ($22.05 in chips) 
Seat 2: Moooose ($22 in chips) 
Seat 3: wpcrso ($19.35 in chips) 
Seat 4: Gerryc009 ($16.80 in chips) 
Seat 5: w.t. spartan ($14.30 in chips) 
Seat 6: outflushed2 ($17.95 in chips) 
Seat 7: lamb1142 ($27.25 in chips) 
Seat 8: 1,1,2,3,5 ($19.70 in chips) 
Seat 9: Haek82 ($29.75 in chips) 
Seat 10: 1nyyfan ($25.95 in chips) 
outflushed2: posts small blind $0.25
lamb1142: posts big blind $0.50
*** HOLE CARDS ***
Dealt to 1,1,2,3,5 [2s 4c]
1,1,2,3,5: folds 
Haek82: folds 
1nyyfan: folds 
JMAC60: folds 
Moooose: folds 
wpcrso: folds 
Gerryc009: calls $0.50
w.t. spartan: folds 
outflushed2: calls $0.25
lamb1142: raises $0.50 to $1
Gerryc009: calls $0.50
outflushed2: calls $0.50
*** FLOP *** [6d Jc 6s]
outflushed2: checks 
lamb1142: bets $0.50
Gerryc009: calls $0.50
outflushed2: calls $0.50
*** TURN *** [6d Jc 6s] [Tc]
outflushed2: checks 
lamb1142: bets $1
Gerryc009: folds 
outflushed2: raises $1 to $2
lamb1142: calls $1
*** RIVER *** [6d Jc 6s Tc] [7h]
outflushed2: bets $1
lamb1142: raises $1 to $2
outflushed2: raises $1 to $3
lamb1142: raises $1 to $4
Betting is capped
outflushed2: calls $1
*** SHOW DOWN ***
lamb1142: shows [7c 7d] (a full house, Sevens full of Sixes)
outflushed2: mucks hand 
lamb1142 collected $16 from pot
*** SUMMARY ***
Total pot $16.50 | Rake $0.50 
Board [6d Jc 6s Tc 7h]
Seat 1: JMAC60 folded before Flop (didn't bet)
Seat 2: Moooose folded before Flop (didn't bet)
Seat 3: wpcrso folded before Flop (didn't bet)
Seat 4: Gerryc009 folded on the Turn
Seat 5: w.t. spartan (button) folded before Flop (didn't bet)
Seat 6: outflushed2 (small blind) mucked [6h Ah]
Seat 7: lamb1142 (big blind) showed [7c 7d] and won ($16) with a full house, Sevens full of Sixes
Seat 8: 1,1,2,3,5 folded before Flop (didn't bet)
Seat 9: Haek82 folded before Flop (didn't bet)
Seat 10: 1nyyfan folded before Flop (didn't bet)



PokerStars Game #6808495936:  Hold'em Limit ($0.50/$1.00) - 2006/10/28 - 22:05:24 (ET)
Table 'Tanina' 10-max Seat #6 is the button
Seat 1: JMAC60 ($22.05 in chips) 
Seat 2: Moooose ($22 in chips) 
Seat 3: wpcrso ($19.35 in chips) 
Seat 4: Gerryc009 ($15.30 in chips) 
Seat 5: w.t. spartan ($14.30 in chips) 
Seat 6: outflushed2 ($10.45 in chips) 
Seat 7: lamb1142 ($35.75 in chips) 
Seat 8: 1,1,2,3,5 ($19.70 in chips) 
Seat 9: Haek82 ($29.75 in chips) 
Seat 10: 1nyyfan ($25.95 in chips) 
lamb1142: posts small blind $0.25
1,1,2,3,5: posts big blind $0.50
*** HOLE CARDS ***
Dealt to 1,1,2,3,5 [6d Th]
Haek82: folds 
1nyyfan: folds 
JMAC60: folds 
Moooose: folds 
wpcrso: folds 
Gerryc009: folds 
w.t. spartan: folds 
outflushed2: folds 
outflushed2 is sitting out
lamb1142: folds 
1,1,2,3,5 collected $0.50 from pot
1,1,2,3,5: doesn't show hand 
*** SUMMARY ***
Total pot $0.50 | Rake $0 
Seat 1: JMAC60 folded before Flop (didn't bet)
Seat 2: Moooose folded before Flop (didn't bet)
Seat 3: wpcrso folded before Flop (didn't bet)
Seat 4: Gerryc009 folded before Flop (didn't bet)
Seat 5: w.t. spartan folded before Flop (didn't bet)
Seat 6: outflushed2 (button) folded before Flop (didn't bet)
Seat 7: lamb1142 (small blind) folded before Flop
Seat 8: 1,1,2,3,5 (big blind) collected ($0.50)
Seat 9: Haek82 folded before Flop (didn't bet)
Seat 10: 1nyyfan folded before Flop (didn't bet)



PokerStars Game #6808499930:  Hold'em Limit ($0.50/$1.00) - 2006/10/28 - 22:05:43 (ET)
Table 'Tanina' 10-max Seat #7 is the button
Seat 1: JMAC60 ($22.05 in chips) 
Seat 2: Moooose ($22 in chips) 
Seat 3: wpcrso ($19.35 in chips) 
Seat 4: Gerryc009 ($15.30 in chips) 
Seat 5: w.t. spartan ($14.30 in chips) 
Seat 7: lamb1142 ($35.50 in chips) 
Seat 8: 1,1,2,3,5 ($19.95 in chips) 
Seat 9: Haek82 ($29.75 in chips) 
Seat 10: 1nyyfan ($25.95 in chips) 
1,1,2,3,5: posts small blind $0.25
Haek82: posts big blind $0.50
*** HOLE CARDS ***
Dealt to 1,1,2,3,5 [Ks 2c]
1nyyfan: calls $0.50
JMAC60: folds 
Moooose: folds 
wpcrso: folds 
Gerryc009: folds 
w.t. spartan: folds 
Moooose leaves the table
lamb1142: raises $0.50 to $1
1,1,2,3,5: folds 
Haek82: calls $0.50
1nyyfan: calls $0.50
*** FLOP *** [5d 9h 6c]
Haek82: checks 
1nyyfan: checks 
lamb1142: bets $0.50
Haek82: calls $0.50
1nyyfan: calls $0.50
*** TURN *** [5d 9h 6c] [Ac]
Haek82: checks 
1nyyfan: checks 
lamb1142: bets $1
Haek82: folds 
1nyyfan: folds 
lamb1142 collected $4.55 from pot
*** SUMMARY ***
Total pot $4.75 | Rake $0.20 
Board [5d 9h 6c Ac]
Seat 1: JMAC60 folded before Flop (didn't bet)
Seat 2: Moooose folded before Flop (didn't bet)
Seat 3: wpcrso folded before Flop (didn't bet)
Seat 4: Gerryc009 folded before Flop (didn't bet)
Seat 5: w.t. spartan folded before Flop (didn't bet)
Seat 7: lamb1142 (button) collected ($4.55)
Seat 8: 1,1,2,3,5 (small blind) folded before Flop
Seat 9: Haek82 (big blind) folded on the Turn
Seat 10: 1nyyfan folded on the Turn



PokerStars Game #6808508668:  Hold'em Limit ($0.50/$1.00) - 2006/10/28 - 22:06:25 (ET)
Table 'Tanina' 10-max Seat #8 is the button
Seat 1: JMAC60 ($22.05 in chips) 
Seat 3: wpcrso ($19.35 in chips) 
Seat 4: Gerryc009 ($15.30 in chips) 
Seat 5: w.t. spartan ($14.30 in chips) 
Seat 7: lamb1142 ($38.55 in chips) 
Seat 8: 1,1,2,3,5 ($19.70 in chips) 
Seat 9: Haek82 ($28.25 in chips) 
Seat 10: 1nyyfan ($24.45 in chips) 
Haek82: posts small blind $0.25
1nyyfan: posts big blind $0.50
*** HOLE CARDS ***
Dealt to 1,1,2,3,5 [Jh 3c]
JMAC60: folds 
wpcrso: folds 
Gerryc009: folds 
w.t. spartan: folds 
lamb1142: folds 
1,1,2,3,5: folds 
Haek82: calls $0.25
1nyyfan: checks 
*** FLOP *** [5h Qc Kh]
Haek82: checks 
1nyyfan: checks 
*** TURN *** [5h Qc Kh] [Ac]
Haek82: bets $1
1nyyfan: calls $1
*** RIVER *** [5h Qc Kh Ac] [Kc]
Haek82: checks 
1nyyfan: bets $1
Haek82: folds 
1nyyfan collected $2.90 from pot
*** SUMMARY ***
Total pot $3 | Rake $0.10 
Board [5h Qc Kh Ac Kc]
Seat 1: JMAC60 folded before Flop (didn't bet)
Seat 3: wpcrso folded before Flop (didn't bet)
Seat 4: Gerryc009 folded before Flop (didn't bet)
Seat 5: w.t. spartan folded before Flop (didn't bet)
Seat 7: lamb1142 folded before Flop (didn't bet)
Seat 8: 1,1,2,3,5 (button) folded before Flop (didn't bet)
Seat 9: Haek82 (small blind) folded on the River
Seat 10: 1nyyfan (big blind) collected ($2.90)



PokerStars Game #6808514504:  Hold'em Limit ($0.50/$1.00) - 2006/10/28 - 22:06:54 (ET)
Table 'Tanina' 10-max Seat #9 is the button
Seat 1: JMAC60 ($22.05 in chips) 
Seat 3: wpcrso ($19.35 in chips) 
Seat 4: Gerryc009 ($15.30 in chips) 
Seat 5: w.t. spartan ($14.30 in chips) 
Seat 7: lamb1142 ($38.55 in chips) 
Seat 8: 1,1,2,3,5 ($19.70 in chips) 
Seat 9: Haek82 ($26.75 in chips) 
Seat 10: 1nyyfan ($25.85 in chips) 
1nyyfan: posts small blind $0.25
JMAC60: posts big blind $0.50
*** HOLE CARDS ***
Dealt to 1,1,2,3,5 [3h 4s]
wpcrso: folds 
Gerryc009: folds 
w.t. spartan: calls $0.50
lamb1142: folds 
1,1,2,3,5: folds 
Haek82: folds 
1nyyfan: calls $0.25
JMAC60: checks 
*** FLOP *** [5h 4d Qh]
1nyyfan: bets $0.50
JMAC60: calls $0.50
outflushed2 has returned
w.t. spartan: folds 
*** TURN *** [5h 4d Qh] [3d]
1nyyfan: bets $1
JMAC60: raises $1 to $2
1nyyfan: calls $1
*** RIVER *** [5h 4d Qh 3d] [8c]
1nyyfan: checks 
JMAC60: bets $1
1nyyfan: calls $1
*** SHOW DOWN ***
JMAC60: shows [7c 6s] (a straight, Four to Eight)
1nyyfan: mucks hand 
JMAC60 collected $8.10 from pot
*** SUMMARY ***
Total pot $8.50 | Rake $0.40 
Board [5h 4d Qh 3d 8c]
Seat 1: JMAC60 (big blind) showed [7c 6s] and won ($8.10) with a straight, Four to Eight
Seat 3: wpcrso folded before Flop (didn't bet)
Seat 4: Gerryc009 folded before Flop (didn't bet)
Seat 5: w.t. spartan folded on the Flop
Seat 7: lamb1142 folded before Flop (didn't bet)
Seat 8: 1,1,2,3,5 folded before Flop (didn't bet)
Seat 9: Haek82 (button) folded before Flop (didn't bet)
Seat 10: 1nyyfan (small blind) mucked [Ad Qd]



PokerStars Game #6808521508:  Hold'em Limit ($0.50/$1.00) - 2006/10/28 - 22:07:25 (ET)
Table 'Tanina' 10-max Seat #10 is the button
Seat 1: JMAC60 ($26.15 in chips) 
Seat 3: wpcrso ($19.35 in chips) 
Seat 4: Gerryc009 ($15.30 in chips) 
Seat 5: w.t. spartan ($13.80 in chips) 
Seat 6: outflushed2 ($10.45 in chips) 
Seat 7: lamb1142 ($38.55 in chips) 
Seat 8: 1,1,2,3,5 ($19.70 in chips) 
Seat 9: Haek82 ($26.75 in chips) 
Seat 10: 1nyyfan ($21.85 in chips) 
JMAC60: posts small blind $0.25
wpcrso: posts big blind $0.50
*** HOLE CARDS ***
Dealt to 1,1,2,3,5 [Kc Ah]
Gerryc009: calls $0.50
w.t. spartan: folds 
outflushed2: folds 
lamb1142: folds 
1,1,2,3,5: raises $0.50 to $1
Haek82: folds 
1nyyfan: folds 
JMAC60: folds 
wpcrso: folds 
Gerryc009: calls $0.50
*** FLOP *** [4h 2d 7s]
Gerryc009: checks 
1,1,2,3,5: checks 
*** TURN *** [4h 2d 7s] [6h]
Gerryc009: checks 
1,1,2,3,5: checks 
*** RIVER *** [4h 2d 7s 6h] [Qd]
JUNin joins the table at seat #2 
Gerryc009: checks 
1,1,2,3,5: checks 
*** SHOW DOWN ***
Gerryc009: shows [8d Kd] (high card King)
1,1,2,3,5: shows [Kc Ah] (high card Ace)
1,1,2,3,5 collected $2.65 from pot
*** SUMMARY ***
Total pot $2.75 | Rake $0.10 
Board [4h 2d 7s 6h Qd]
Seat 1: JMAC60 (small blind) folded before Flop
Seat 3: wpcrso (big blind) folded before Flop
Seat 4: Gerryc009 showed [8d Kd] and lost with high card King
Seat 5: w.t. spartan folded before Flop (didn't bet)
Seat 6: outflushed2 folded before Flop (didn't bet)
Seat 7: lamb1142 folded before Flop (didn't bet)
Seat 8: 1,1,2,3,5 showed [Kc Ah] and won ($2.65) with high card Ace
Seat 9: Haek82 folded before Flop (didn't bet)
Seat 10: 1nyyfan (button) folded before Flop (didn't bet)



PokerStars Game #6808531257:  Hold'em Limit ($0.50/$1.00) - 2006/10/28 - 22:08:11 (ET)
Table 'Tanina' 10-max Seat #1 is the button
Seat 1: JMAC60 ($25.90 in chips) 
Seat 3: wpcrso ($18.85 in chips) 
Seat 4: Gerryc009 ($14.30 in chips) 
Seat 5: w.t. spartan ($13.80 in chips) 
Seat 6: outflushed2 ($10.45 in chips) 
Seat 7: lamb1142 ($38.55 in chips) 
Seat 8: 1,1,2,3,5 ($21.35 in chips) 
Seat 9: Haek82 ($26.75 in chips) 
Seat 10: 1nyyfan ($21.85 in chips) 
JUNin will be allowed to play after the button
wpcrso: posts small blind $0.25
Gerryc009: posts big blind $0.50
*** HOLE CARDS ***
Dealt to 1,1,2,3,5 [6s 6h]
w.t. spartan: folds 
outflushed2: folds 
lamb1142: calls $0.50
1,1,2,3,5: calls $0.50
Haek82: calls $0.50
1nyyfan: folds 
JMAC60: folds 
wpcrso has timed out while being disconnected
wpcrso is being treated as all-in
Gerryc009: checks 
*** FLOP *** [Th 2c 3h]
Gerryc009: checks 
lamb1142: checks 
1,1,2,3,5: checks 
Haek82: bets $0.50
wpcrso is connected 
Gerryc009: folds 
lamb1142: folds 
1,1,2,3,5: folds 
*** TURN *** [Th 2c 3h] [As]
*** RIVER *** [Th 2c 3h As] [Js]
*** SHOW DOWN ***
Haek82: shows [Ks Qd] (a straight, Ten to Ace)
Haek82 collected $0.95 from side pot
wpcrso: mucks hand 
wpcrso is sitting out
Haek82 collected $1.20 from main pot
*** SUMMARY ***
Total pot $2.25 Main pot $1.20. Side pot $0.95. | Rake $0.10 
Board [Th 2c 3h As Js]
Seat 1: JMAC60 (button) folded before Flop (didn't bet)
Seat 3: wpcrso (small blind) mucked [3s 4c]
Seat 4: Gerryc009 (big blind) folded on the Flop
Seat 5: w.t. spartan folded before Flop (didn't bet)
Seat 6: outflushed2 folded before Flop (didn't bet)
Seat 7: lamb1142 folded on the Flop
Seat 8: 1,1,2,3,5 folded on the Flop
Seat 9: Haek82 showed [Ks Qd] and won ($2.15) with a straight, Ten to Ace
Seat 10: 1nyyfan folded before Flop (didn't bet)



PokerStars Game #6808543203:  Hold'em Limit ($0.50/$1.00) - 2006/10/28 - 22:09:08 (ET)
Table 'Tanina' 10-max Seat #4 is the button
Seat 1: JMAC60 ($25.90 in chips) 
Seat 2: JUNin ($20 in chips) 
Seat 4: Gerryc009 ($13.80 in chips) 
Seat 5: w.t. spartan ($13.80 in chips) 
Seat 6: outflushed2 ($10.45 in chips) 
Seat 7: lamb1142 ($38.05 in chips) 
Seat 8: 1,1,2,3,5 ($20.85 in chips) 
Seat 9: Haek82 ($28.40 in chips) 
Seat 10: 1nyyfan ($21.85 in chips) 
w.t. spartan: posts small blind $0.25
outflushed2: posts big blind $0.50
JUNin: posts big blind $0.50
*** HOLE CARDS ***
Dealt to 1,1,2,3,5 [Jc 9s]
wpcrso has returned
lamb1142: folds 
1,1,2,3,5: folds 
Haek82: folds 
1nyyfan: folds 
JMAC60: raises $0.50 to $1
JUNin: folds 
Gerryc009: folds 
w.t. spartan: calls $0.75
outflushed2: calls $0.50
*** FLOP *** [7d Kd Js]
w.t. spartan: checks 
outflushed2: checks 
JMAC60: checks 
*** TURN *** [7d Kd Js] [Ks]
w.t. spartan: checks 
outflushed2: checks 
JMAC60: bets $1
w.t. spartan: folds 
outflushed2: folds 
JMAC60 collected $3.35 from pot
JMAC60: doesn't show hand 
*** SUMMARY ***
Total pot $3.50 | Rake $0.15 
Board [7d Kd Js Ks]
Seat 1: JMAC60 collected ($3.35)
Seat 2: JUNin folded before Flop
Seat 4: Gerryc009 (button) folded before Flop (didn't bet)
Seat 5: w.t. spartan (small blind) folded on the Turn
Seat 6: outflushed2 (big blind) folded on the Turn
Seat 7: lamb1142 folded before Flop (didn't bet)
Seat 8: 1,1,2,3,5 folded before Flop (didn't bet)
Seat 9: Haek82 folded before Flop (didn't bet)
Seat 10: 1nyyfan folded before Flop (didn't bet)



PokerStars Game #6808550986:  Hold'em Limit ($0.50/$1.00) - 2006/10/28 - 22:09:46 (ET)
Table 'Tanina' 10-max Seat #5 is the button
Seat 1: JMAC60 ($28.25 in chips) 
Seat 2: JUNin ($19.50 in chips) 
Seat 3: wpcrso ($18.60 in chips) 
Seat 4: Gerryc009 ($13.80 in chips) 
Seat 5: w.t. spartan ($12.80 in chips) 
Seat 6: outflushed2 ($9.45 in chips) 
Seat 7: lamb1142 ($38.05 in chips) 
Seat 8: 1,1,2,3,5 ($20.85 in chips) 
Seat 9: Haek82 ($28.40 in chips) 
Seat 10: 1nyyfan ($21.85 in chips) 
outflushed2: posts small blind $0.25
lamb1142: posts big blind $0.50
*** HOLE CARDS ***
Dealt to 1,1,2,3,5 [2d 4d]
1,1,2,3,5: folds 
Haek82: folds 
1nyyfan: calls $0.50
JMAC60: folds 
JUNin: folds 
wpcrso: raises $0.50 to $1
Gerryc009: calls $1
w.t. spartan: folds 
outflushed2: calls $0.75
lamb1142: folds 
1nyyfan: calls $0.50
*** FLOP *** [Js 8s 9c]
outflushed2: checks 
1nyyfan: bets $0.50
wpcrso: calls $0.50
Gerryc009: raises $0.50 to $1
outflushed2: folds 
1nyyfan: calls $0.50
wpcrso: calls $0.50
*** TURN *** [Js 8s 9c] [Qs]
1nyyfan: checks 
wpcrso: bets $1
Gerryc009: raises $1 to $2
1nyyfan: calls $2
wpcrso: calls $1
*** RIVER *** [Js 8s 9c Qs] [Jc]
1nyyfan: checks 
wpcrso: checks 
Gerryc009: bets $1
1nyyfan: raises $1 to $2
wpcrso: folds 
Gerryc009: raises $1 to $3
1nyyfan: raises $1 to $4
Betting is capped
Gerryc009: calls $1
*** SHOW DOWN ***
1nyyfan: shows [9h 9d] (a full house, Nines full of Jacks)
Gerryc009: mucks hand 
1nyyfan collected $21 from pot
*** SUMMARY ***
Total pot $21.50 | Rake $0.50 
Board [Js 8s 9c Qs Jc]
Seat 1: JMAC60 folded before Flop (didn't bet)
Seat 2: JUNin folded before Flop (didn't bet)
Seat 3: wpcrso folded on the River
Seat 4: Gerryc009 mucked [Qc Td]
Seat 5: w.t. spartan (button) folded before Flop (didn't bet)
Seat 6: outflushed2 (small blind) folded on the Flop
Seat 7: lamb1142 (big blind) folded before Flop
Seat 8: 1,1,2,3,5 folded before Flop (didn't bet)
Seat 9: Haek82 folded before Flop (didn't bet)
Seat 10: 1nyyfan showed [9h 9d] and won ($21) with a full house, Nines full of Jacks



PokerStars Game #6808565714:  Hold'em Limit ($0.50/$1.00) - 2006/10/28 - 22:10:57 (ET)
Table 'Tanina' 10-max Seat #6 is the button
Seat 1: JMAC60 ($28.25 in chips) 
Seat 2: JUNin ($19.50 in chips) 
Seat 3: wpcrso ($14.60 in chips) 
Seat 4: Gerryc009 ($5.80 in chips) 
Seat 5: w.t. spartan ($12.80 in chips) 
Seat 6: outflushed2 ($8.45 in chips) 
Seat 7: lamb1142 ($37.55 in chips) 
Seat 8: 1,1,2,3,5 ($20.85 in chips) 
Seat 9: Haek82 ($28.40 in chips) 
Seat 10: 1nyyfan ($34.85 in chips) 
lamb1142: posts small blind $0.25
1,1,2,3,5: posts big blind $0.50
*** HOLE CARDS ***
Dealt to 1,1,2,3,5 [Jd 9c]
Haek82: raises $0.50 to $1
1nyyfan: folds 
JMAC60: folds 
JUNin: folds 
wpcrso: folds 
Gerryc009: folds 
w.t. spartan: folds 
outflushed2: folds 
lamb1142: folds 
1,1,2,3,5: folds 
Haek82 collected $1.25 from pot
Haek82: shows [Ac Ad] (a pair of Aces)
*** SUMMARY ***
Total pot $1.25 | Rake $0 
Seat 1: JMAC60 folded before Flop (didn't bet)
Seat 2: JUNin folded before Flop (didn't bet)
Seat 3: wpcrso folded before Flop (didn't bet)
Seat 4: Gerryc009 folded before Flop (didn't bet)
Seat 5: w.t. spartan folded before Flop (didn't bet)
Seat 6: outflushed2 (button) folded before Flop (didn't bet)
Seat 7: lamb1142 (small blind) folded before Flop
Seat 8: 1,1,2,3,5 (big blind) folded before Flop
Seat 9: Haek82 collected ($1.25)
Seat 10: 1nyyfan folded before Flop (didn't bet)



PokerStars Game #6808570762:  Hold'em Limit ($0.50/$1.00) - 2006/10/28 - 22:11:21 (ET)
Table 'Tanina' 10-max Seat #7 is the button
Seat 1: JMAC60 ($28.25 in chips) 
Seat 2: JUNin ($19.50 in chips) 
Seat 3: wpcrso ($14.60 in chips) 
Seat 4: Gerryc009 ($5.80 in chips) 
Seat 5: w.t. spartan ($12.80 in chips) 
Seat 6: outflushed2 ($8.45 in chips) 
Seat 7: lamb1142 ($37.30 in chips) 
Seat 8: 1,1,2,3,5 ($20.35 in chips) 
Seat 9: Haek82 ($29.15 in chips) 
Seat 10: 1nyyfan ($34.85 in chips) 
1,1,2,3,5: posts small blind $0.25
Haek82: posts big blind $0.50
*** HOLE CARDS ***
Dealt to 1,1,2,3,5 [Qc 9d]
1nyyfan: folds 
JMAC60: folds 
JUNin: folds 
wpcrso: folds 
Gerryc009: calls $0.50
w.t. spartan: folds 
outflushed2: raises $0.50 to $1
lamb1142: folds 
1,1,2,3,5: folds 
Haek82: calls $0.50
Gerryc009: calls $0.50
*** FLOP *** [5h 4c Ac]
Haek82: checks 
Gerryc009: bets $0.50
outflushed2: raises $0.50 to $1
Haek82: folds 
Gerryc009: calls $0.50
*** TURN *** [5h 4c Ac] [9s]
Gerryc009: checks 
outflushed2: bets $1
Gerryc009: calls $1
*** RIVER *** [5h 4c Ac 9s] [9c]
Gerryc009: bets $1
outflushed2: calls $1
*** SHOW DOWN ***
Gerryc009: shows [Ad 8d] (two pair, Aces and Nines)
outflushed2: shows [As Kc] (two pair, Aces and Nines - King kicker)
outflushed2 collected $8.85 from pot
*** SUMMARY ***
Total pot $9.25 | Rake $0.40 
Board [5h 4c Ac 9s 9c]
Seat 1: JMAC60 folded before Flop (didn't bet)
Seat 2: JUNin folded before Flop (didn't bet)
Seat 3: wpcrso folded before Flop (didn't bet)
Seat 4: Gerryc009 showed [Ad 8d] and lost with two pair, Aces and Nines
Seat 5: w.t. spartan folded before Flop (didn't bet)
Seat 6: outflushed2 showed [As Kc] and won ($8.85) with two pair, Aces and Nines
Seat 7: lamb1142 (button) folded before Flop (didn't bet)
Seat 8: 1,1,2,3,5 (small blind) folded before Flop
Seat 9: Haek82 (big blind) folded on the Flop
Seat 10: 1nyyfan folded before Flop (didn't bet)



PokerStars Game #6808581570:  Hold'em Limit ($0.50/$1.00) - 2006/10/28 - 22:12:13 (ET)
Table 'Tanina' 10-max Seat #8 is the button
Seat 1: JMAC60 ($28.25 in chips) 
Seat 2: JUNin ($19.50 in chips) 
Seat 3: wpcrso ($14.60 in chips) 
Seat 4: Gerryc009 ($1.80 in chips) 
Seat 5: w.t. spartan ($12.80 in chips) 
Seat 6: outflushed2 ($13.30 in chips) 
Seat 7: lamb1142 ($37.30 in chips) 
Seat 8: 1,1,2,3,5 ($20.10 in chips) 
Seat 9: Haek82 ($28.15 in chips) 
Seat 10: 1nyyfan ($34.85 in chips) 
Haek82: posts small blind $0.25
1nyyfan: posts big blind $0.50
*** HOLE CARDS ***
Dealt to 1,1,2,3,5 [Jh 7c]
JMAC60: folds 
JUNin: raises $0.50 to $1
wpcrso: folds 
Gerryc009: raises $0.50 to $1.50
w.t. spartan: folds 
outflushed2: folds 
lamb1142: folds 
1,1,2,3,5: folds 
Haek82: folds 
1nyyfan: calls $1
JUNin: raises $0.50 to $2
Betting is capped
Gerryc009: calls $0.30 and is all-in
1nyyfan: calls $0.50
*** FLOP *** [9s 6s 5c]
1nyyfan: checks 
JUNin: bets $0.50
1nyyfan: calls $0.50
*** TURN *** [9s 6s 5c] [3d]
1nyyfan: checks 
JUNin: bets $1
1nyyfan: calls $1
*** RIVER *** [9s 6s 5c 3d] [3h]
1nyyfan: checks 
JUNin: bets $1
1nyyfan: calls $1
*** SHOW DOWN ***
JUNin: shows [As Qs] (a pair of Threes)
1nyyfan: shows [7s 7d] (two pair, Sevens and Threes)
1nyyfan collected $5.15 from side pot
Gerryc009: mucks hand 
1nyyfan collected $5.40 from main pot
*** SUMMARY ***
Total pot $11.05 Main pot $5.40. Side pot $5.15. | Rake $0.50 
Board [9s 6s 5c 3d 3h]
Seat 1: JMAC60 folded before Flop (didn't bet)
Seat 2: JUNin showed [As Qs] and lost with a pair of Threes
Seat 3: wpcrso folded before Flop (didn't bet)
Seat 4: Gerryc009 mucked [Ah Kd]
Seat 5: w.t. spartan folded before Flop (didn't bet)
Seat 6: outflushed2 folded before Flop (didn't bet)
Seat 7: lamb1142 folded before Flop (didn't bet)
Seat 8: 1,1,2,3,5 (button) folded before Flop (didn't bet)
Seat 9: Haek82 (small blind) folded before Flop
Seat 10: 1nyyfan (big blind) showed [7s 7d] and won ($10.55) with two pair, Sevens and Threes



PokerStars Game #6808591561:  Hold'em Limit ($0.50/$1.00) - 2006/10/28 - 22:13:00 (ET)
Table 'Tanina' 10-max Seat #9 is the button
Seat 1: JMAC60 ($28.25 in chips) 
Seat 2: JUNin ($15 in chips) 
Seat 3: wpcrso ($14.60 in chips) 
Seat 5: w.t. spartan ($12.80 in chips) 
Seat 6: outflushed2 ($13.30 in chips) 
Seat 7: lamb1142 ($37.30 in chips) 
Seat 8: 1,1,2,3,5 ($20.10 in chips) 
Seat 9: Haek82 ($27.90 in chips) 
Seat 10: 1nyyfan ($40.90 in chips) 
1nyyfan: posts small blind $0.25
JMAC60: posts big blind $0.50
*** HOLE CARDS ***
Dealt to 1,1,2,3,5 [Qc Ac]
Gerryc009 leaves the table
JUNin: folds 
wpcrso: folds 
w.t. spartan: raises $0.50 to $1
outflushed2: folds 
lamb1142: folds 
1,1,2,3,5: raises $0.50 to $1.50
Haek82: folds 
1nyyfan: folds 
JMAC60: folds 
w.t. spartan: calls $0.50
*** FLOP *** [Qs 5h 2s]
w.t. spartan: checks 
1,1,2,3,5: bets $0.50
w.t. spartan: calls $0.50
*** TURN *** [Qs 5h 2s] [Ts]
MrKGBoreoman joins the table at seat #4 
w.t. spartan: checks 
1,1,2,3,5: checks 
*** RIVER *** [Qs 5h 2s Ts] [4h]
w.t. spartan: checks 
1,1,2,3,5: bets $1
w.t. spartan: calls $1
*** SHOW DOWN ***
1,1,2,3,5: shows [Qc Ac] (a pair of Queens)
w.t. spartan: shows [Kc Qh] (a pair of Queens - lower kicker)
1,1,2,3,5 collected $6.45 from pot
*** SUMMARY ***
Total pot $6.75 | Rake $0.30 
Board [Qs 5h 2s Ts 4h]
Seat 1: JMAC60 (big blind) folded before Flop
Seat 2: JUNin folded before Flop (didn't bet)
Seat 3: wpcrso folded before Flop (didn't bet)
Seat 5: w.t. spartan showed [Kc Qh] and lost with a pair of Queens
Seat 6: outflushed2 folded before Flop (didn't bet)
Seat 7: lamb1142 folded before Flop (didn't bet)
Seat 8: 1,1,2,3,5 showed [Qc Ac] and won ($6.45) with a pair of Queens
Seat 9: Haek82 (button) folded before Flop (didn't bet)
Seat 10: 1nyyfan (small blind) folded before Flop



PokerStars Game #6808602913:  Hold'em Limit ($0.50/$1.00) - 2006/10/28 - 22:13:54 (ET)
Table 'Tanina' 10-max Seat #10 is the button
Seat 1: JMAC60 ($27.75 in chips) 
Seat 2: JUNin ($15 in chips) 
Seat 3: wpcrso ($14.60 in chips) 
Seat 5: w.t. spartan ($9.80 in chips) 
Seat 6: outflushed2 ($13.30 in chips) 
Seat 7: lamb1142 ($37.30 in chips) 
Seat 8: 1,1,2,3,5 ($23.55 in chips) 
Seat 9: Haek82 ($27.90 in chips) 
Seat 10: 1nyyfan ($40.65 in chips) 
JMAC60: posts small blind $0.25
JUNin: posts big blind $0.50
MrKGBoreoman: sits out 
*** HOLE CARDS ***
Dealt to 1,1,2,3,5 [9h Kh]
wpcrso: folds 
w.t. spartan: calls $0.50
outflushed2: folds 
lamb1142: folds 
1,1,2,3,5: folds 
Haek82: calls $0.50
1nyyfan: folds 
JMAC60: calls $0.25
JUNin: checks 
*** FLOP *** [Jc Tc 7c]
JMAC60: bets $0.50
JUNin: folds 
w.t. spartan: calls $0.50
Haek82: folds 
*** TURN *** [Jc Tc 7c] [Ad]
JMAC60: bets $1
w.t. spartan: folds 
JMAC60 collected $2.90 from pot
JMAC60: doesn't show hand 
*** SUMMARY ***
Total pot $3 | Rake $0.10 
Board [Jc Tc 7c Ad]
Seat 1: JMAC60 (small blind) collected ($2.90)
Seat 2: JUNin (big blind) folded on the Flop
Seat 3: wpcrso folded before Flop (didn't bet)
Seat 5: w.t. spartan folded on the Turn
Seat 6: outflushed2 folded before Flop (didn't bet)
Seat 7: lamb1142 folded before Flop (didn't bet)
Seat 8: 1,1,2,3,5 folded before Flop (didn't bet)
Seat 9: Haek82 folded on the Flop
Seat 10: 1nyyfan (button) folded before Flop (didn't bet)



PokerStars Game #6808611326:  Hold'em Limit ($0.50/$1.00) - 2006/10/28 - 22:14:35 (ET)
Table 'Tanina' 10-max Seat #1 is the button
Seat 1: JMAC60 ($29.65 in chips) 
Seat 2: JUNin ($14.50 in chips) 
Seat 3: wpcrso ($14.60 in chips) 
Seat 5: w.t. spartan ($8.80 in chips) 
Seat 6: outflushed2 ($13.30 in chips) 
Seat 7: lamb1142 ($37.30 in chips) 
Seat 8: 1,1,2,3,5 ($23.55 in chips) 
Seat 9: Haek82 ($27.40 in chips) 
Seat 10: 1nyyfan ($40.65 in chips) 
JUNin: posts small blind $0.25
wpcrso: posts big blind $0.50
MrKGBoreoman: sits out 
*** HOLE CARDS ***
Dealt to 1,1,2,3,5 [8c Tc]
w.t. spartan: folds 
outflushed2: folds 
lamb1142: folds 
1,1,2,3,5: folds 
Haek82: folds 
1nyyfan: folds 
JMAC60: folds 
JUNin: folds 
wpcrso collected $0.50 from pot
wpcrso: doesn't show hand 
*** SUMMARY ***
Total pot $0.50 | Rake $0 
Seat 1: JMAC60 (button) folded before Flop (didn't bet)
Seat 2: JUNin (small blind) folded before Flop
Seat 3: wpcrso (big blind) collected ($0.50)
Seat 5: w.t. spartan folded before Flop (didn't bet)
Seat 6: outflushed2 folded before Flop (didn't bet)
Seat 7: lamb1142 folded before Flop (didn't bet)
Seat 8: 1,1,2,3,5 folded before Flop (didn't bet)
Seat 9: Haek82 folded before Flop (didn't bet)
Seat 10: 1nyyfan folded before Flop (didn't bet)



PokerStars Game #6808616608:  Hold'em Limit ($0.50/$1.00) - 2006/10/28 - 22:15:00 (ET)
Table 'Tanina' 10-max Seat #2 is the button
Seat 1: JMAC60 ($29.65 in chips) 
Seat 2: JUNin ($14.25 in chips) 
Seat 3: wpcrso ($14.85 in chips) 
Seat 4: MrKGBoreoman ($20 in chips) 
Seat 5: w.t. spartan ($8.80 in chips) 
Seat 6: outflushed2 ($13.30 in chips) 
Seat 7: lamb1142 ($37.30 in chips) 
Seat 8: 1,1,2,3,5 ($23.55 in chips) 
Seat 9: Haek82 ($27.40 in chips) 
Seat 10: 1nyyfan ($40.65 in chips) 
wpcrso: posts small blind $0.25
MrKGBoreoman: posts big blind $0.50
*** HOLE CARDS ***
Dealt to 1,1,2,3,5 [7h 8d]
w.t. spartan: calls $0.50
outflushed2: folds 
lamb1142: folds 
1,1,2,3,5: folds 
Haek82: folds 
1nyyfan: folds 
JMAC60: folds 
JUNin: folds 
wpcrso: calls $0.25
MrKGBoreoman: checks 
*** FLOP *** [Kd Qc 7s]
wpcrso: checks 
MrKGBoreoman: checks 
w.t. spartan: bets $0.50
wpcrso: folds 
MrKGBoreoman: folds 
w.t. spartan collected $1.45 from pot
w.t. spartan: doesn't show hand 
*** SUMMARY ***
Total pot $1.50 | Rake $0.05 
Board [Kd Qc 7s]
Seat 1: JMAC60 folded before Flop (didn't bet)
Seat 2: JUNin (button) folded before Flop (didn't bet)
Seat 3: wpcrso (small blind) folded on the Flop
Seat 4: MrKGBoreoman (big blind) folded on the Flop
Seat 5: w.t. spartan collected ($1.45)
Seat 6: outflushed2 folded before Flop (didn't bet)
Seat 7: lamb1142 folded before Flop (didn't bet)
Seat 8: 1,1,2,3,5 folded before Flop (didn't bet)
Seat 9: Haek82 folded before Flop (didn't bet)
Seat 10: 1nyyfan folded before Flop (didn't bet)



PokerStars Game #6808626418:  Hold'em Limit ($0.50/$1.00) - 2006/10/28 - 22:15:45 (ET)
Table 'Tanina' 10-max Seat #3 is the button
Seat 1: JMAC60 ($29.65 in chips) 
Seat 2: JUNin ($14.25 in chips) 
Seat 3: wpcrso ($14.35 in chips) 
Seat 4: MrKGBoreoman ($19.50 in chips) 
Seat 5: w.t. spartan ($9.75 in chips) 
Seat 6: outflushed2 ($13.30 in chips) 
Seat 7: lamb1142 ($37.30 in chips) 
Seat 8: 1,1,2,3,5 ($23.55 in chips) 
Seat 9: Haek82 ($27.40 in chips) 
Seat 10: 1nyyfan ($40.65 in chips) 
MrKGBoreoman: posts small blind $0.25
w.t. spartan: posts big blind $0.50
*** HOLE CARDS ***
Dealt to 1,1,2,3,5 [3s 8h]
outflushed2: folds 
lamb1142: folds 
1,1,2,3,5: folds 
Haek82: raises $0.50 to $1
1nyyfan: folds 
JMAC60: folds 
JUNin: folds 
wpcrso: folds 
MrKGBoreoman: folds 
w.t. spartan: calls $0.50
*** FLOP *** [4d 5s Tc]
w.t. spartan: bets $0.50
Haek82: raises $0.50 to $1
w.t. spartan: calls $0.50
*** TURN *** [4d 5s Tc] [Qc]
w.t. spartan: checks 
Haek82: bets $1
w.t. spartan: calls $1
*** RIVER *** [4d 5s Tc Qc] [Jh]
w.t. spartan: checks 
Haek82: bets $1
w.t. spartan: calls $1
*** SHOW DOWN ***
Haek82: shows [Ad 6s] (high card Ace)
w.t. spartan: shows [9c Th] (a pair of Tens)
w.t. spartan collected $7.90 from pot
*** SUMMARY ***
Total pot $8.25 | Rake $0.35 
Board [4d 5s Tc Qc Jh]
Seat 1: JMAC60 folded before Flop (didn't bet)
Seat 2: JUNin folded before Flop (didn't bet)
Seat 3: wpcrso (button) folded before Flop (didn't bet)
Seat 4: MrKGBoreoman (small blind) folded before Flop
Seat 5: w.t. spartan (big blind) showed [9c Th] and won ($7.90) with a pair of Tens
Seat 6: outflushed2 folded before Flop (didn't bet)
Seat 7: lamb1142 folded before Flop (didn't bet)
Seat 8: 1,1,2,3,5 folded before Flop (didn't bet)
Seat 9: Haek82 showed [Ad 6s] and lost with high card Ace
Seat 10: 1nyyfan folded before Flop (didn't bet)



PokerStars Game #6808635731:  Hold'em Limit ($0.50/$1.00) - 2006/10/28 - 22:16:29 (ET)
Table 'Tanina' 10-max Seat #4 is the button
Seat 1: JMAC60 ($29.65 in chips) 
Seat 2: JUNin ($14.25 in chips) 
Seat 3: wpcrso ($14.35 in chips) 
Seat 4: MrKGBoreoman ($19.25 in chips) 
Seat 5: w.t. spartan ($13.65 in chips) 
Seat 6: outflushed2 ($13.30 in chips) 
Seat 7: lamb1142 ($37.30 in chips) 
Seat 8: 1,1,2,3,5 ($23.55 in chips) 
Seat 9: Haek82 ($23.40 in chips) 
Seat 10: 1nyyfan ($40.65 in chips) 
w.t. spartan: posts small blind $0.25
outflushed2: posts big blind $0.50
*** HOLE CARDS ***
Dealt to 1,1,2,3,5 [9s Qs]
lamb1142: folds 
1,1,2,3,5: folds 
Haek82: folds 
1nyyfan: calls $0.50
JMAC60: calls $0.50
JUNin: folds 
wpcrso: folds 
MrKGBoreoman: folds 
w.t. spartan: calls $0.25
outflushed2: checks 
*** FLOP *** [Jd 9d Ts]
w.t. spartan: checks 
outflushed2: checks 
1nyyfan: bets $0.50
JMAC60: raises $0.50 to $1
w.t. spartan: folds 
outflushed2: folds 
1nyyfan: calls $0.50
*** TURN *** [Jd 9d Ts] [5d]
1nyyfan: bets $1
JMAC60: calls $1
*** RIVER *** [Jd 9d Ts 5d] [4d]
1nyyfan: bets $1
JMAC60: calls $1
*** SHOW DOWN ***
1nyyfan: shows [Ad 8d] (a flush, Ace high)
JMAC60: mucks hand 
1nyyfan collected $7.65 from pot
*** SUMMARY ***
Total pot $8 | Rake $0.35 
Board [Jd 9d Ts 5d 4d]
Seat 1: JMAC60 mucked [Jc Qh]
Seat 2: JUNin folded before Flop (didn't bet)
Seat 3: wpcrso folded before Flop (didn't bet)
Seat 4: MrKGBoreoman (button) folded before Flop (didn't bet)
Seat 5: w.t. spartan (small blind) folded on the Flop
Seat 6: outflushed2 (big blind) folded on the Flop
Seat 7: lamb1142 folded before Flop (didn't bet)
Seat 8: 1,1,2,3,5 folded before Flop (didn't bet)
Seat 9: Haek82 folded before Flop (didn't bet)
Seat 10: 1nyyfan showed [Ad 8d] and won ($7.65) with a flush, Ace high



PokerStars Game #6808649286:  Hold'em Limit ($0.50/$1.00) - 2006/10/28 - 22:17:33 (ET)
Table 'Tanina' 10-max Seat #5 is the button
Seat 1: JMAC60 ($26.15 in chips) 
Seat 2: JUNin ($14.25 in chips) 
Seat 3: wpcrso ($14.35 in chips) 
Seat 4: MrKGBoreoman ($19.25 in chips) 
Seat 5: w.t. spartan ($13.15 in chips) 
Seat 6: outflushed2 ($12.80 in chips) 
Seat 7: lamb1142 ($37.30 in chips) 
Seat 8: 1,1,2,3,5 ($23.55 in chips) 
Seat 9: Haek82 ($23.40 in chips) 
Seat 10: 1nyyfan ($44.80 in chips) 
outflushed2: posts small blind $0.25
lamb1142: posts big blind $0.50
*** HOLE CARDS ***
Dealt to 1,1,2,3,5 [9d 6h]
1,1,2,3,5: folds 
Haek82: raises $0.50 to $1
1nyyfan: calls $1
JMAC60: folds 
JUNin: folds 
wpcrso: folds 
MrKGBoreoman: folds 
w.t. spartan: folds 
outflushed2: folds 
lamb1142: folds 
*** FLOP *** [Jc Jd 6s]
Haek82: checks 
1nyyfan: checks 
*** TURN *** [Jc Jd 6s] [As]
Haek82: checks 
1nyyfan: checks 
*** RIVER *** [Jc Jd 6s As] [3c]
Haek82: bets $1
1nyyfan: folds 
Haek82 collected $2.65 from pot
Haek82: doesn't show hand 
*** SUMMARY ***
Total pot $2.75 | Rake $0.10 
Board [Jc Jd 6s As 3c]
Seat 1: JMAC60 folded before Flop (didn't bet)
Seat 2: JUNin folded before Flop (didn't bet)
Seat 3: wpcrso folded before Flop (didn't bet)
Seat 4: MrKGBoreoman folded before Flop (didn't bet)
Seat 5: w.t. spartan (button) folded before Flop (didn't bet)
Seat 6: outflushed2 (small blind) folded before Flop
Seat 7: lamb1142 (big blind) folded before Flop
Seat 8: 1,1,2,3,5 folded before Flop (didn't bet)
Seat 9: Haek82 collected ($2.65)
Seat 10: 1nyyfan folded on the River



PokerStars Game #6808656524:  Hold'em Limit ($0.50/$1.00) - 2006/10/28 - 22:18:06 (ET)
Table 'Tanina' 10-max Seat #6 is the button
Seat 1: JMAC60 ($26.15 in chips) 
Seat 2: JUNin ($14.25 in chips) 
Seat 3: wpcrso ($14.35 in chips) 
Seat 4: MrKGBoreoman ($19.25 in chips) 
Seat 5: w.t. spartan ($13.15 in chips) 
Seat 6: outflushed2 ($12.55 in chips) 
Seat 7: lamb1142 ($36.80 in chips) 
Seat 8: 1,1,2,3,5 ($23.55 in chips) 
Seat 9: Haek82 ($25.05 in chips) 
Seat 10: 1nyyfan ($43.80 in chips) 
lamb1142: posts small blind $0.25
1,1,2,3,5: posts big blind $0.50
*** HOLE CARDS ***
Dealt to 1,1,2,3,5 [9d 8c]
Haek82: calls $0.50
1nyyfan: folds 
JMAC60: folds 
JUNin: folds 
wpcrso: folds 
MrKGBoreoman: folds 
w.t. spartan: calls $0.50
outflushed2: folds 
lamb1142: folds 
1,1,2,3,5: checks 
*** FLOP *** [3d Td Kd]
1,1,2,3,5: bets $0.50
Haek82: calls $0.50
w.t. spartan: folds 
*** TURN *** [3d Td Kd] [3h]
1,1,2,3,5: bets $1
Haek82: folds 
1,1,2,3,5 collected $2.65 from pot
1,1,2,3,5: doesn't show hand 
*** SUMMARY ***
Total pot $2.75 | Rake $0.10 
Board [3d Td Kd 3h]
Seat 1: JMAC60 folded before Flop (didn't bet)
Seat 2: JUNin folded before Flop (didn't bet)
Seat 3: wpcrso folded before Flop (didn't bet)
Seat 4: MrKGBoreoman folded before Flop (didn't bet)
Seat 5: w.t. spartan folded on the Flop
Seat 6: outflushed2 (button) folded before Flop (didn't bet)
Seat 7: lamb1142 (small blind) folded before Flop
Seat 8: 1,1,2,3,5 (big blind) collected ($2.65)
Seat 9: Haek82 folded on the Turn
Seat 10: 1nyyfan folded before Flop (didn't bet)



PokerStars Game #6808665779:  Hold'em Limit ($0.50/$1.00) - 2006/10/28 - 22:18:49 (ET)
Table 'Tanina' 10-max Seat #7 is the button
Seat 1: JMAC60 ($26.15 in chips) 
Seat 2: JUNin ($14.25 in chips) 
Seat 3: wpcrso ($14.35 in chips) 
Seat 4: MrKGBoreoman ($19.25 in chips) 
Seat 5: w.t. spartan ($12.65 in chips) 
Seat 6: outflushed2 ($12.55 in chips) 
Seat 7: lamb1142 ($36.55 in chips) 
Seat 8: 1,1,2,3,5 ($25.20 in chips) 
Seat 9: Haek82 ($24.05 in chips) 
Seat 10: 1nyyfan ($43.80 in chips) 
1,1,2,3,5: posts small blind $0.25
Haek82: posts big blind $0.50
*** HOLE CARDS ***
Dealt to 1,1,2,3,5 [9s Th]
1nyyfan: folds 
JMAC60: folds 
JUNin: raises $0.50 to $1
wpcrso: folds 
MrKGBoreoman: folds 
w.t. spartan: folds 
outflushed2: folds 
lamb1142: folds 
1,1,2,3,5: folds 
Haek82: folds 
JUNin collected $1.25 from pot
*** SUMMARY ***
Total pot $1.25 | Rake $0 
Seat 1: JMAC60 folded before Flop (didn't bet)
Seat 2: JUNin collected ($1.25)
Seat 3: wpcrso folded before Flop (didn't bet)
Seat 4: MrKGBoreoman folded before Flop (didn't bet)
Seat 5: w.t. spartan folded before Flop (didn't bet)
Seat 6: outflushed2 folded before Flop (didn't bet)
Seat 7: lamb1142 (button) folded before Flop (didn't bet)
Seat 8: 1,1,2,3,5 (small blind) folded before Flop
Seat 9: Haek82 (big blind) folded before Flop
Seat 10: 1nyyfan folded before Flop (didn't bet)



PokerStars Game #6808670141:  Hold'em Limit ($0.50/$1.00) - 2006/10/28 - 22:19:10 (ET)
Table 'Tanina' 10-max Seat #8 is the button
Seat 1: JMAC60 ($26.15 in chips) 
Seat 2: JUNin ($15 in chips) 
Seat 3: wpcrso ($14.35 in chips) 
Seat 4: MrKGBoreoman ($19.25 in chips) 
Seat 5: w.t. spartan ($12.65 in chips) 
Seat 6: outflushed2 ($12.55 in chips) 
Seat 7: lamb1142 ($36.55 in chips) 
Seat 8: 1,1,2,3,5 ($24.95 in chips) 
Seat 9: Haek82 ($23.55 in chips) 
Seat 10: 1nyyfan ($43.80 in chips) 
Haek82: posts small blind $0.25
1nyyfan: posts big blind $0.50
*** HOLE CARDS ***
Dealt to 1,1,2,3,5 [Ac 3c]
JMAC60: folds 
JUNin: calls $0.50
wpcrso: raises $0.50 to $1
MrKGBoreoman: folds 
w.t. spartan: folds 
outflushed2: folds 
lamb1142: folds 
1,1,2,3,5: folds 
Haek82: folds 
1nyyfan: calls $0.50
JUNin: calls $0.50
*** FLOP *** [6d 5d 6c]
1nyyfan: checks 
JUNin: checks 
wpcrso: bets $0.50
1nyyfan: calls $0.50
JUNin: folds 
*** TURN *** [6d 5d 6c] [Kh]
1nyyfan: checks 
wpcrso: bets $1
1nyyfan: folds 
wpcrso collected $4.05 from pot
wpcrso: doesn't show hand 
*** SUMMARY ***
Total pot $4.25 | Rake $0.20 
Board [6d 5d 6c Kh]
Seat 1: JMAC60 folded before Flop (didn't bet)
Seat 2: JUNin folded on the Flop
Seat 3: wpcrso collected ($4.05)
Seat 4: MrKGBoreoman folded before Flop (didn't bet)
Seat 5: w.t. spartan folded before Flop (didn't bet)
Seat 6: outflushed2 folded before Flop (didn't bet)
Seat 7: lamb1142 folded before Flop (didn't bet)
Seat 8: 1,1,2,3,5 (button) folded before Flop (didn't bet)
Seat 9: Haek82 (small blind) folded before Flop
Seat 10: 1nyyfan (big blind) folded on the Turn



PokerStars Game #6808682364:  Hold'em Limit ($0.50/$1.00) - 2006/10/28 - 22:20:07 (ET)
Table 'Tanina' 10-max Seat #9 is the button
Seat 1: JMAC60 ($26.15 in chips) 
Seat 2: JUNin ($14 in chips) 
Seat 3: wpcrso ($16.90 in chips) 
Seat 4: MrKGBoreoman ($19.25 in chips) 
Seat 5: w.t. spartan ($12.65 in chips) 
Seat 6: outflushed2 ($12.55 in chips) 
Seat 7: lamb1142 ($36.55 in chips) 
Seat 8: 1,1,2,3,5 ($24.95 in chips) 
Seat 9: Haek82 ($23.30 in chips) 
Seat 10: 1nyyfan ($42.30 in chips) 
1nyyfan: posts small blind $0.25
JMAC60: posts big blind $0.50
*** HOLE CARDS ***
Dealt to 1,1,2,3,5 [Qc Ad]
JUNin: folds 
wpcrso: folds 
MrKGBoreoman: folds 
w.t. spartan: folds 
outflushed2: folds 
lamb1142: calls $0.50
1,1,2,3,5: raises $0.50 to $1
Haek82: calls $1
1nyyfan: folds 
JMAC60: folds 
lamb1142: calls $0.50
*** FLOP *** [Th Js 9s]
lamb1142: checks 
1,1,2,3,5: bets $0.50
Haek82: calls $0.50
lamb1142: calls $0.50
*** TURN *** [Th Js 9s] [Ac]
lamb1142: checks 
1,1,2,3,5: bets $1
Haek82: calls $1
lamb1142: calls $1
*** RIVER *** [Th Js 9s Ac] [8h]
lamb1142: checks 
1,1,2,3,5: bets $1
Haek82: raises $1 to $2
lamb1142: folds 
1,1,2,3,5: calls $1
*** SHOW DOWN ***
Haek82: shows [As Qd] (a straight, Eight to Queen)
1,1,2,3,5: shows [Qc Ad] (a straight, Eight to Queen)
1,1,2,3,5 collected $5.90 from pot
Haek82 collected $5.85 from pot
*** SUMMARY ***
Total pot $12.25 | Rake $0.50 
Board [Th Js 9s Ac 8h]
Seat 1: JMAC60 (big blind) folded before Flop
Seat 2: JUNin folded before Flop (didn't bet)
Seat 3: wpcrso folded before Flop (didn't bet)
Seat 4: MrKGBoreoman folded before Flop (didn't bet)
Seat 5: w.t. spartan folded before Flop (didn't bet)
Seat 6: outflushed2 folded before Flop (didn't bet)
Seat 7: lamb1142 folded on the River
Seat 8: 1,1,2,3,5 showed [Qc Ad] and won ($5.90) with a straight, Eight to Queen
Seat 9: Haek82 (button) showed [As Qd] and won ($5.85) with a straight, Eight to Queen
Seat 10: 1nyyfan (small blind) folded before Flop



PokerStars Game #6808695391:  Hold'em Limit ($0.50/$1.00) - 2006/10/28 - 22:21:10 (ET)
Table 'Tanina' 10-max Seat #10 is the button
Seat 1: JMAC60 ($25.65 in chips) 
Seat 2: JUNin ($14 in chips) 
Seat 3: wpcrso ($16.90 in chips) 
Seat 4: MrKGBoreoman ($19.25 in chips) 
Seat 5: w.t. spartan ($12.65 in chips) 
Seat 6: outflushed2 ($12.55 in chips) 
Seat 7: lamb1142 ($34.05 in chips) 
Seat 8: 1,1,2,3,5 ($26.35 in chips) 
Seat 9: Haek82 ($24.65 in chips) 
Seat 10: 1nyyfan ($42.05 in chips) 
JMAC60: posts small blind $0.25
JUNin: posts big blind $0.50
*** HOLE CARDS ***
Dealt to 1,1,2,3,5 [4s Ah]
wpcrso: raises $0.50 to $1
MrKGBoreoman: folds 
w.t. spartan: folds 
outflushed2: folds 
lamb1142: folds 
1,1,2,3,5: folds 
Haek82: folds 
1nyyfan: calls $1
JMAC60: folds 
JUNin: folds 
*** FLOP *** [Jh 2s 5h]
wpcrso: bets $0.50
1nyyfan: calls $0.50
*** TURN *** [Jh 2s 5h] [7h]
wpcrso: checks 
1nyyfan: checks 
*** RIVER *** [Jh 2s 5h 7h] [9d]
wpcrso: checks 
1nyyfan: checks 
*** SHOW DOWN ***
wpcrso: shows [Ac Kc] (high card Ace)
1nyyfan: shows [3s 3c] (a pair of Threes)
1nyyfan collected $3.60 from pot
*** SUMMARY ***
Total pot $3.75 | Rake $0.15 
Board [Jh 2s 5h 7h 9d]
Seat 1: JMAC60 (small blind) folded before Flop
Seat 2: JUNin (big blind) folded before Flop
Seat 3: wpcrso showed [Ac Kc] and lost with high card Ace
Seat 4: MrKGBoreoman folded before Flop (didn't bet)
Seat 5: w.t. spartan folded before Flop (didn't bet)
Seat 6: outflushed2 folded before Flop (didn't bet)
Seat 7: lamb1142 folded before Flop (didn't bet)
Seat 8: 1,1,2,3,5 folded before Flop (didn't bet)
Seat 9: Haek82 folded before Flop (didn't bet)
Seat 10: 1nyyfan (button) showed [3s 3c] and won ($3.60) with a pair of Threes



PokerStars Game #6808704090:  Hold'em Limit ($0.50/$1.00) - 2006/10/28 - 22:21:50 (ET)
Table 'Tanina' 10-max Seat #1 is the button
Seat 1: JMAC60 ($25.40 in chips) 
Seat 2: JUNin ($13.50 in chips) 
Seat 3: wpcrso ($15.40 in chips) 
Seat 4: MrKGBoreoman ($19.25 in chips) 
Seat 5: w.t. spartan ($12.65 in chips) 
Seat 6: outflushed2 ($12.55 in chips) 
Seat 7: lamb1142 ($34.05 in chips) 
Seat 8: 1,1,2,3,5 ($26.35 in chips) 
Seat 9: Haek82 ($24.65 in chips) 
Seat 10: 1nyyfan ($44.15 in chips) 
JUNin: posts small blind $0.25
wpcrso: posts big blind $0.50
*** HOLE CARDS ***
Dealt to 1,1,2,3,5 [2h 7d]
MrKGBoreoman: folds 
w.t. spartan: folds 
outflushed2: folds 
lamb1142: folds 
1,1,2,3,5: folds 
Haek82: raises $0.50 to $1
1nyyfan: folds 
JMAC60: folds 
JUNin: folds 
wpcrso: folds 
Haek82 collected $1.25 from pot
*** SUMMARY ***
Total pot $1.25 | Rake $0 
Seat 1: JMAC60 (button) folded before Flop (didn't bet)
Seat 2: JUNin (small blind) folded before Flop
Seat 3: wpcrso (big blind) folded before Flop
Seat 4: MrKGBoreoman folded before Flop (didn't bet)
Seat 5: w.t. spartan folded before Flop (didn't bet)
Seat 6: outflushed2 folded before Flop (didn't bet)
Seat 7: lamb1142 folded before Flop (didn't bet)
Seat 8: 1,1,2,3,5 folded before Flop (didn't bet)
Seat 9: Haek82 collected ($1.25)
Seat 10: 1nyyfan folded before Flop (didn't bet)



PokerStars Game #6808708149:  Hold'em Limit ($0.50/$1.00) - 2006/10/28 - 22:22:09 (ET)
Table 'Tanina' 10-max Seat #2 is the button
Seat 1: JMAC60 ($25.40 in chips) 
Seat 2: JUNin ($13.25 in chips) 
Seat 3: wpcrso ($14.90 in chips) 
Seat 4: MrKGBoreoman ($19.25 in chips) 
Seat 5: w.t. spartan ($12.65 in chips) 
Seat 6: outflushed2 ($12.55 in chips) 
Seat 7: lamb1142 ($34.05 in chips) 
Seat 8: 1,1,2,3,5 ($26.35 in chips) 
Seat 9: Haek82 ($25.40 in chips) 
Seat 10: 1nyyfan ($44.15 in chips) 
wpcrso: posts small blind $0.25
MrKGBoreoman: posts big blind $0.50
*** HOLE CARDS ***
Dealt to 1,1,2,3,5 [Ad Ks]
w.t. spartan: folds 
outflushed2: folds 
lamb1142: folds 
1,1,2,3,5: raises $0.50 to $1
Haek82: folds 
1nyyfan: folds 
JMAC60: folds 
JUNin: folds 
wpcrso: folds 
MrKGBoreoman: folds 
1,1,2,3,5 collected $1.25 from pot
1,1,2,3,5: doesn't show hand 
*** SUMMARY ***
Total pot $1.25 | Rake $0 
Seat 1: JMAC60 folded before Flop (didn't bet)
Seat 2: JUNin (button) folded before Flop (didn't bet)
Seat 3: wpcrso (small blind) folded before Flop
Seat 4: MrKGBoreoman (big blind) folded before Flop
Seat 5: w.t. spartan folded before Flop (didn't bet)
Seat 6: outflushed2 folded before Flop (didn't bet)
Seat 7: lamb1142 folded before Flop (didn't bet)
Seat 8: 1,1,2,3,5 collected ($1.25)
Seat 9: Haek82 folded before Flop (didn't bet)
Seat 10: 1nyyfan folded before Flop (didn't bet)



PokerStars Game #6808716093:  Hold'em Limit ($0.50/$1.00) - 2006/10/28 - 22:22:42 (ET)
Table 'Tanina' 10-max Seat #3 is the button
Seat 1: JMAC60 ($25.40 in chips) 
Seat 2: JUNin ($13.25 in chips) 
Seat 3: wpcrso ($14.65 in chips) 
Seat 4: MrKGBoreoman ($18.75 in chips) 
Seat 5: w.t. spartan ($12.65 in chips) 
Seat 6: outflushed2 ($12.55 in chips) 
Seat 7: lamb1142 ($34.05 in chips) 
Seat 8: 1,1,2,3,5 ($27.10 in chips) 
Seat 9: Haek82 ($25.40 in chips) 
Seat 10: 1nyyfan ($44.15 in chips) 
MrKGBoreoman: posts small blind $0.25
w.t. spartan: posts big blind $0.50
*** HOLE CARDS ***
Dealt to 1,1,2,3,5 [Jd 2h]
outflushed2: folds 
lamb1142: folds 
1,1,2,3,5: folds 
outflushed2 leaves the table
Haek82: folds 
1nyyfan: folds 
JMAC60: folds 
JUNin: folds 
wpcrso: calls $0.50
MrKGBoreoman: folds 
w.t. spartan: checks 
*** FLOP *** [6h 5h Qh]
w.t. spartan: checks 
wpcrso: checks 
*** TURN *** [6h 5h Qh] [8s]
w.t. spartan: checks 
OCbarrister joins the table at seat #6 
wpcrso: checks 
*** RIVER *** [6h 5h Qh 8s] [9s]
w.t. spartan: checks 
wpcrso: checks 
*** SHOW DOWN ***
w.t. spartan: shows [Tc 5s] (a pair of Fives)
wpcrso: shows [9d Ad] (a pair of Nines)
wpcrso collected $1.20 from pot
*** SUMMARY ***
Total pot $1.25 | Rake $0.05 
Board [6h 5h Qh 8s 9s]
Seat 1: JMAC60 folded before Flop (didn't bet)
Seat 2: JUNin folded before Flop (didn't bet)
Seat 3: wpcrso (button) showed [9d Ad] and won ($1.20) with a pair of Nines
Seat 4: MrKGBoreoman (small blind) folded before Flop
Seat 5: w.t. spartan (big blind) showed [Tc 5s] and lost with a pair of Fives
Seat 6: outflushed2 folded before Flop (didn't bet)
Seat 7: lamb1142 folded before Flop (didn't bet)
Seat 8: 1,1,2,3,5 folded before Flop (didn't bet)
Seat 9: Haek82 folded before Flop (didn't bet)
Seat 10: 1nyyfan folded before Flop (didn't bet)



PokerStars Game #6808723943:  Hold'em Limit ($0.50/$1.00) - 2006/10/28 - 22:23:17 (ET)
Table 'Tanina' 10-max Seat #4 is the button
Seat 1: JMAC60 ($25.40 in chips) 
Seat 2: JUNin ($13.25 in chips) 
Seat 3: wpcrso ($15.35 in chips) 
Seat 4: MrKGBoreoman ($18.50 in chips) 
Seat 5: w.t. spartan ($12.15 in chips) 
Seat 6: OCbarrister ($20 in chips) 
Seat 7: lamb1142 ($34.05 in chips) 
Seat 8: 1,1,2,3,5 ($27.10 in chips) 
Seat 9: Haek82 ($25.40 in chips) 
Seat 10: 1nyyfan ($44.15 in chips) 
w.t. spartan: posts small blind $0.25
OCbarrister: posts big blind $0.50
*** HOLE CARDS ***
Dealt to 1,1,2,3,5 [8s 2d]
lamb1142: calls $0.50
1,1,2,3,5: folds 
Haek82: folds 
1nyyfan: folds 
JMAC60: raises $0.50 to $1
JUNin: folds 
wpcrso: folds 
MrKGBoreoman: folds 
w.t. spartan: folds 
OCbarrister: calls $0.50
lamb1142: calls $0.50
*** FLOP *** [9c Jh 8d]
OCbarrister: checks 
lamb1142: checks 
JMAC60: bets $0.50
OCbarrister: calls $0.50
lamb1142: calls $0.50
*** TURN *** [9c Jh 8d] [9s]
OCbarrister: checks 
lamb1142: checks 
JMAC60: bets $1
OCbarrister: calls $1
lamb1142: calls $1
*** RIVER *** [9c Jh 8d 9s] [Td]
OCbarrister: checks 
lamb1142: checks 
JMAC60: checks 
*** SHOW DOWN ***
OCbarrister: shows [Kd 9d] (three of a kind, Nines)
lamb1142: mucks hand 
JMAC60: mucks hand 
OCbarrister collected $7.40 from pot
*** SUMMARY ***
Total pot $7.75 | Rake $0.35 
Board [9c Jh 8d 9s Td]
Seat 1: JMAC60 mucked [Ac Ah]
Seat 2: JUNin folded before Flop (didn't bet)
Seat 3: wpcrso folded before Flop (didn't bet)
Seat 4: MrKGBoreoman (button) folded before Flop (didn't bet)
Seat 5: w.t. spartan (small blind) folded before Flop
Seat 6: OCbarrister (big blind) showed [Kd 9d] and won ($7.40) with three of a kind, Nines
Seat 7: lamb1142 mucked [2c 2h]
Seat 8: 1,1,2,3,5 folded before Flop (didn't bet)
Seat 9: Haek82 folded before Flop (didn't bet)
Seat 10: 1nyyfan folded before Flop (didn't bet)



PokerStars Game #6808740205:  Hold'em Limit ($0.50/$1.00) - 2006/10/28 - 22:24:30 (ET)
Table 'Tanina' 10-max Seat #5 is the button
Seat 1: JMAC60 ($22.90 in chips) 
Seat 2: JUNin ($13.25 in chips) 
Seat 3: wpcrso ($15.35 in chips) 
Seat 4: MrKGBoreoman ($18.50 in chips) 
Seat 5: w.t. spartan ($11.90 in chips) 
Seat 6: OCbarrister ($24.90 in chips) 
Seat 7: lamb1142 ($31.55 in chips) 
Seat 8: 1,1,2,3,5 ($27.10 in chips) 
Seat 9: Haek82 ($25.40 in chips) 
Seat 10: 1nyyfan ($44.15 in chips) 
OCbarrister: posts small blind $0.25
lamb1142: posts big blind $0.50
*** HOLE CARDS ***
Dealt to 1,1,2,3,5 [Kd 5s]
1,1,2,3,5: folds 
Haek82: calls $0.50
1nyyfan: folds 
JMAC60: folds 
JUNin: folds 
wpcrso: folds 
MrKGBoreoman: folds 
w.t. spartan: calls $0.50
OCbarrister: calls $0.25
lamb1142: raises $0.50 to $1
Haek82: calls $0.50
w.t. spartan: calls $0.50
OCbarrister: calls $0.50
*** FLOP *** [4c 9h 9d]
OCbarrister: checks 
lamb1142: bets $0.50
Haek82: folds 
w.t. spartan: folds 
OCbarrister: calls $0.50
*** TURN *** [4c 9h 9d] [Ah]
Haek82 said, "jojojojojoj"
OCbarrister: checks 
lamb1142: bets $1
OCbarrister: folds 
lamb1142 collected $4.80 from pot
*** SUMMARY ***
Total pot $5 | Rake $0.20 
Board [4c 9h 9d Ah]
Seat 1: JMAC60 folded before Flop (didn't bet)
Seat 2: JUNin folded before Flop (didn't bet)
Seat 3: wpcrso folded before Flop (didn't bet)
Seat 4: MrKGBoreoman folded before Flop (didn't bet)
Seat 5: w.t. spartan (button) folded on the Flop
Seat 6: OCbarrister (small blind) folded on the Turn
Seat 7: lamb1142 (big blind) collected ($4.80)
Seat 8: 1,1,2,3,5 folded before Flop (didn't bet)
Seat 9: Haek82 folded on the Flop
Seat 10: 1nyyfan folded before Flop (didn't bet)



PokerStars Game #6808752504:  Hold'em Limit ($0.50/$1.00) - 2006/10/28 - 22:25:25 (ET)
Table 'Tanina' 10-max Seat #6 is the button
Seat 1: JMAC60 ($22.90 in chips) 
Seat 2: JUNin ($13.25 in chips) 
Seat 3: wpcrso ($15.35 in chips) 
Seat 4: MrKGBoreoman ($18.50 in chips) 
Seat 5: w.t. spartan ($10.90 in chips) 
Seat 6: OCbarrister ($23.40 in chips) 
Seat 7: lamb1142 ($34.85 in chips) 
Seat 8: 1,1,2,3,5 ($27.10 in chips) 
Seat 9: Haek82 ($24.40 in chips) 
Seat 10: 1nyyfan ($44.15 in chips) 
lamb1142: posts small blind $0.25
1,1,2,3,5: posts big blind $0.50
*** HOLE CARDS ***
Dealt to 1,1,2,3,5 [5d 4d]
Haek82: raises $0.50 to $1
1nyyfan: folds 
JMAC60: folds 
JUNin: folds 
wpcrso: folds 
MrKGBoreoman: folds 
w.t. spartan: calls $1
OCbarrister: calls $1
lamb1142: folds 
1,1,2,3,5: folds 
*** FLOP *** [Ad 9h 6d]
Haek82: bets $0.50
w.t. spartan: calls $0.50
OCbarrister: folds 
*** TURN *** [Ad 9h 6d] [Ah]
Haek82: bets $1
w.t. spartan: raises $1 to $2
Haek82: calls $1
*** RIVER *** [Ad 9h 6d Ah] [6c]
Haek82: checks 
w.t. spartan: bets $1
Haek82: calls $1
*** SHOW DOWN ***
w.t. spartan: shows [8d Ac] (a full house, Aces full of Sixes)
Haek82: shows [Jh As] (a full house, Aces full of Sixes)
Haek82 collected $5.15 from pot
w.t. spartan collected $5.10 from pot
*** SUMMARY ***
Total pot $10.75 | Rake $0.50 
Board [Ad 9h 6d Ah 6c]
Seat 1: JMAC60 folded before Flop (didn't bet)
Seat 2: JUNin folded before Flop (didn't bet)
Seat 3: wpcrso folded before Flop (didn't bet)
Seat 4: MrKGBoreoman folded before Flop (didn't bet)
Seat 5: w.t. spartan showed [8d Ac] and won ($5.10) with a full house, Aces full of Sixes
Seat 6: OCbarrister (button) folded on the Flop
Seat 7: lamb1142 (small blind) folded before Flop
Seat 8: 1,1,2,3,5 (big blind) folded before Flop
Seat 9: Haek82 showed [Jh As] and won ($5.15) with a full house, Aces full of Sixes
Seat 10: 1nyyfan folded before Flop (didn't bet)



PokerStars Game #6808762114:  Hold'em Limit ($0.50/$1.00) - 2006/10/28 - 22:26:08 (ET)
Table 'Tanina' 10-max Seat #7 is the button
Seat 1: JMAC60 ($22.90 in chips) 
Seat 2: JUNin ($13.25 in chips) 
Seat 3: wpcrso ($15.35 in chips) 
Seat 4: MrKGBoreoman ($18.50 in chips) 
Seat 5: w.t. spartan ($11.50 in chips) 
Seat 6: OCbarrister ($22.40 in chips) 
Seat 7: lamb1142 ($34.60 in chips) 
Seat 8: 1,1,2,3,5 ($26.60 in chips) 
Seat 9: Haek82 ($25.05 in chips) 
Seat 10: 1nyyfan ($44.15 in chips) 
1,1,2,3,5: posts small blind $0.25
Haek82: posts big blind $0.50
*** HOLE CARDS ***
Dealt to 1,1,2,3,5 [9d 9s]
1nyyfan: folds 
JMAC60: folds 
JUNin: folds 
wpcrso: folds 
MrKGBoreoman: folds 
w.t. spartan: folds 
OCbarrister: folds 
lamb1142: folds 
1,1,2,3,5: raises $0.50 to $1
Haek82: folds 
1,1,2,3,5 collected $1 from pot
1,1,2,3,5: doesn't show hand 
*** SUMMARY ***
Total pot $1 | Rake $0 
Seat 1: JMAC60 folded before Flop (didn't bet)
Seat 2: JUNin folded before Flop (didn't bet)
Seat 3: wpcrso folded before Flop (didn't bet)
Seat 4: MrKGBoreoman folded before Flop (didn't bet)
Seat 5: w.t. spartan folded before Flop (didn't bet)
Seat 6: OCbarrister folded before Flop (didn't bet)
Seat 7: lamb1142 (button) folded before Flop (didn't bet)
Seat 8: 1,1,2,3,5 (small blind) collected ($1)
Seat 9: Haek82 (big blind) folded before Flop
Seat 10: 1nyyfan folded before Flop (didn't bet)



PokerStars Game #6808767599:  Hold'em Limit ($0.50/$1.00) - 2006/10/28 - 22:26:33 (ET)
Table 'Tanina' 10-max Seat #8 is the button
Seat 1: JMAC60 ($22.90 in chips) 
Seat 2: JUNin ($13.25 in chips) 
Seat 3: wpcrso ($15.35 in chips) 
Seat 4: MrKGBoreoman ($18.50 in chips) 
Seat 5: w.t. spartan ($11.50 in chips) 
Seat 6: OCbarrister ($22.40 in chips) 
Seat 7: lamb1142 ($34.60 in chips) 
Seat 8: 1,1,2,3,5 ($27.10 in chips) 
Seat 9: Haek82 ($24.55 in chips) 
Seat 10: 1nyyfan ($44.15 in chips) 
Haek82: posts small blind $0.25
1nyyfan: posts big blind $0.50
*** HOLE CARDS ***
Dealt to 1,1,2,3,5 [3c Ts]
JMAC60: folds 
JUNin: folds 
wpcrso: folds 
MrKGBoreoman: raises $0.50 to $1
w.t. spartan: calls $1
OCbarrister: folds 
lamb1142: folds 
1,1,2,3,5: folds 
Haek82: folds 
1nyyfan: folds 
*** FLOP *** [Th Ks 2c]
MrKGBoreoman: bets $0.50
w.t. spartan: calls $0.50
*** TURN *** [Th Ks 2c] [Ac]
MrKGBoreoman: checks 
w.t. spartan: checks 
*** RIVER *** [Th Ks 2c Ac] [4d]
MrKGBoreoman: checks 
w.t. spartan: checks 
*** SHOW DOWN ***
MrKGBoreoman: shows [Qs Kc] (a pair of Kings)
w.t. spartan: mucks hand 
MrKGBoreoman collected $3.60 from pot
*** SUMMARY ***
Total pot $3.75 | Rake $0.15 
Board [Th Ks 2c Ac 4d]
Seat 1: JMAC60 folded before Flop (didn't bet)
Seat 2: JUNin folded before Flop (didn't bet)
Seat 3: wpcrso folded before Flop (didn't bet)
Seat 4: MrKGBoreoman showed [Qs Kc] and won ($3.60) with a pair of Kings
Seat 5: w.t. spartan mucked [9s 9h]
Seat 6: OCbarrister folded before Flop (didn't bet)
Seat 7: lamb1142 folded before Flop (didn't bet)
Seat 8: 1,1,2,3,5 (button) folded before Flop (didn't bet)
Seat 9: Haek82 (small blind) folded before Flop
Seat 10: 1nyyfan (big blind) folded before Flop



PokerStars Game #6808779073:  Hold'em Limit ($0.50/$1.00) - 2006/10/28 - 22:27:25 (ET)
Table 'Tanina' 10-max Seat #9 is the button
Seat 1: JMAC60 ($22.90 in chips) 
Seat 2: JUNin ($13.25 in chips) 
Seat 3: wpcrso ($15.35 in chips) 
Seat 4: MrKGBoreoman ($20.60 in chips) 
Seat 5: w.t. spartan ($10 in chips) 
Seat 6: OCbarrister ($22.40 in chips) 
Seat 7: lamb1142 ($34.60 in chips) 
Seat 8: 1,1,2,3,5 ($27.10 in chips) 
Seat 9: Haek82 ($24.30 in chips) 
Seat 10: 1nyyfan ($43.65 in chips) 
1nyyfan: posts small blind $0.25
JMAC60: posts big blind $0.50
*** HOLE CARDS ***
Dealt to 1,1,2,3,5 [9d 6d]
JUNin: folds 
wpcrso: folds 
MrKGBoreoman: folds 
w.t. spartan: folds 
OCbarrister: calls $0.50
lamb1142: raises $0.50 to $1
1,1,2,3,5: folds 
Haek82: folds 
1nyyfan: folds 
JMAC60: folds 
OCbarrister: calls $0.50
*** FLOP *** [Jh 2s 5d]
OCbarrister: checks 
lamb1142: bets $0.50
OCbarrister: calls $0.50
*** TURN *** [Jh 2s 5d] [6h]
OCbarrister: checks 
lamb1142: bets $1
OCbarrister: folds 
lamb1142 collected $3.60 from pot
*** SUMMARY ***
Total pot $3.75 | Rake $0.15 
Board [Jh 2s 5d 6h]
Seat 1: JMAC60 (big blind) folded before Flop
Seat 2: JUNin folded before Flop (didn't bet)
Seat 3: wpcrso folded before Flop (didn't bet)
Seat 4: MrKGBoreoman folded before Flop (didn't bet)
Seat 5: w.t. spartan folded before Flop (didn't bet)
Seat 6: OCbarrister folded on the Turn
Seat 7: lamb1142 collected ($3.60)
Seat 8: 1,1,2,3,5 folded before Flop (didn't bet)
Seat 9: Haek82 (button) folded before Flop (didn't bet)
Seat 10: 1nyyfan (small blind) folded before Flop



PokerStars Game #6808791159:  Hold'em Limit ($0.50/$1.00) - 2006/10/28 - 22:28:20 (ET)
Table 'Tanina' 10-max Seat #10 is the button
Seat 1: JMAC60 ($22.40 in chips) 
Seat 2: JUNin ($13.25 in chips) 
Seat 3: wpcrso ($15.35 in chips) 
Seat 4: MrKGBoreoman ($20.60 in chips) 
Seat 5: w.t. spartan ($10 in chips) 
Seat 6: OCbarrister ($20.90 in chips) 
Seat 7: lamb1142 ($36.70 in chips) 
Seat 8: 1,1,2,3,5 ($27.10 in chips) 
Seat 9: Haek82 ($24.30 in chips) 
Seat 10: 1nyyfan ($43.40 in chips) 
JMAC60: posts small blind $0.25
JUNin: posts big blind $0.50
*** HOLE CARDS ***
Dealt to 1,1,2,3,5 [5s 6s]
wpcrso: folds 
MrKGBoreoman: folds 
w.t. spartan: folds 
OCbarrister: calls $0.50
lamb1142: folds 
1,1,2,3,5: folds 
Haek82: folds 
1nyyfan: folds 
JMAC60: folds 
JUNin: checks 
*** FLOP *** [Ad 2h 4h]
JUNin: checks 
OCbarrister: bets $0.50
JUNin: folds 
OCbarrister collected $1.20 from pot
*** SUMMARY ***
Total pot $1.25 | Rake $0.05 
Board [Ad 2h 4h]
Seat 1: JMAC60 (small blind) folded before Flop
Seat 2: JUNin (big blind) folded on the Flop
Seat 3: wpcrso folded before Flop (didn't bet)
Seat 4: MrKGBoreoman folded before Flop (didn't bet)
Seat 5: w.t. spartan folded before Flop (didn't bet)
Seat 6: OCbarrister collected ($1.20)
Seat 7: lamb1142 folded before Flop (didn't bet)
Seat 8: 1,1,2,3,5 folded before Flop (didn't bet)
Seat 9: Haek82 folded before Flop (didn't bet)
Seat 10: 1nyyfan (button) folded before Flop (didn't bet)



PokerStars Game #6808798371:  Hold'em Limit ($0.50/$1.00) - 2006/10/28 - 22:28:54 (ET)
Table 'Tanina' 10-max Seat #1 is the button
Seat 1: JMAC60 ($22.15 in chips) 
Seat 2: JUNin ($12.75 in chips) 
Seat 3: wpcrso ($15.35 in chips) 
Seat 4: MrKGBoreoman ($20.60 in chips) 
Seat 5: w.t. spartan ($10 in chips) 
Seat 6: OCbarrister ($21.60 in chips) 
Seat 7: lamb1142 ($36.70 in chips) 
Seat 8: 1,1,2,3,5 ($27.10 in chips) 
Seat 9: Haek82 ($24.30 in chips) 
Seat 10: 1nyyfan ($43.40 in chips) 
JUNin: posts small blind $0.25
wpcrso: posts big blind $0.50
*** HOLE CARDS ***
Dealt to 1,1,2,3,5 [5h 5s]
MrKGBoreoman: folds 
w.t. spartan: calls $0.50
OCbarrister: folds 
lamb1142: folds 
1,1,2,3,5: calls $0.50
Haek82: folds 
1nyyfan: calls $0.50
JMAC60: calls $0.50
JUNin: folds 
wpcrso: checks 
*** FLOP *** [9c Ts 8h]
wpcrso: checks 
w.t. spartan: checks 
1,1,2,3,5: checks 
1nyyfan: checks 
JMAC60: bets $0.50
wpcrso: calls $0.50
w.t. spartan: calls $0.50
1,1,2,3,5: folds 
1nyyfan: folds 
*** TURN *** [9c Ts 8h] [4c]
wpcrso: checks 
w.t. spartan: checks 
JMAC60: bets $1
wpcrso: calls $1
w.t. spartan: calls $1
*** RIVER *** [9c Ts 8h 4c] [3c]
wpcrso: checks 
w.t. spartan: checks 
JMAC60: bets $1
wpcrso: folds 
w.t. spartan: folds 
JMAC60 collected $6.90 from pot
JMAC60: doesn't show hand 
*** SUMMARY ***
Total pot $7.25 | Rake $0.35 
Board [9c Ts 8h 4c 3c]
Seat 1: JMAC60 (button) collected ($6.90)
Seat 2: JUNin (small blind) folded before Flop
Seat 3: wpcrso (big blind) folded on the River
Seat 4: MrKGBoreoman folded before Flop (didn't bet)
Seat 5: w.t. spartan folded on the River
Seat 6: OCbarrister folded before Flop (didn't bet)
Seat 7: lamb1142 folded before Flop (didn't bet)
Seat 8: 1,1,2,3,5 folded on the Flop
Seat 9: Haek82 folded before Flop (didn't bet)
Seat 10: 1nyyfan folded on the Flop



PokerStars Game #6808812906:  Hold'em Limit ($0.50/$1.00) - 2006/10/28 - 22:30:00 (ET)
Table 'Tanina' 10-max Seat #2 is the button
Seat 1: JMAC60 ($27.05 in chips) 
Seat 2: JUNin ($12.50 in chips) 
Seat 3: wpcrso ($13.35 in chips) 
Seat 4: MrKGBoreoman ($20.60 in chips) 
Seat 5: w.t. spartan ($8 in chips) 
Seat 6: OCbarrister ($21.60 in chips) 
Seat 7: lamb1142 ($36.70 in chips) 
Seat 8: 1,1,2,3,5 ($26.60 in chips) 
Seat 9: Haek82 ($24.30 in chips) 
Seat 10: 1nyyfan ($42.90 in chips) 
wpcrso: posts small blind $0.25
MrKGBoreoman: posts big blind $0.50
*** HOLE CARDS ***
Dealt to 1,1,2,3,5 [5c 8d]
w.t. spartan: folds 
OCbarrister: folds 
lamb1142: folds 
1,1,2,3,5: folds 
Haek82: calls $0.50
1nyyfan: folds 
JMAC60: folds 
JUNin: folds 
wpcrso: folds 
MrKGBoreoman: checks 
*** FLOP *** [Td 6h Js]
MrKGBoreoman: checks 
Haek82: bets $0.50
MrKGBoreoman: calls $0.50
*** TURN *** [Td 6h Js] [6c]
MrKGBoreoman: checks 
Haek82: checks 
*** RIVER *** [Td 6h Js 6c] [9s]
MrKGBoreoman: checks 
Haek82: bets $1
MrKGBoreoman: calls $1
*** SHOW DOWN ***
Haek82: shows [Jd Ah] (two pair, Jacks and Sixes)
MrKGBoreoman: mucks hand 
Haek82 collected $4.05 from pot
*** SUMMARY ***
Total pot $4.25 | Rake $0.20 
Board [Td 6h Js 6c 9s]
Seat 1: JMAC60 folded before Flop (didn't bet)
Seat 2: JUNin (button) folded before Flop (didn't bet)
Seat 3: wpcrso (small blind) folded before Flop
Seat 4: MrKGBoreoman (big blind) mucked [Qd Tc]
Seat 5: w.t. spartan folded before Flop (didn't bet)
Seat 6: OCbarrister folded before Flop (didn't bet)
Seat 7: lamb1142 folded before Flop (didn't bet)
Seat 8: 1,1,2,3,5 folded before Flop (didn't bet)
Seat 9: Haek82 showed [Jd Ah] and won ($4.05) with two pair, Jacks and Sixes
Seat 10: 1nyyfan folded before Flop (didn't bet)



PokerStars Game #6808824591:  Hold'em Limit ($0.50/$1.00) - 2006/10/28 - 22:30:54 (ET)
Table 'Tanina' 10-max Seat #3 is the button
Seat 1: JMAC60 ($27.05 in chips) 
Seat 2: JUNin ($12.50 in chips) 
Seat 3: wpcrso ($13.10 in chips) 
Seat 4: MrKGBoreoman ($18.60 in chips) 
Seat 5: w.t. spartan ($8 in chips) 
Seat 6: OCbarrister ($21.60 in chips) 
Seat 7: lamb1142 ($36.70 in chips) 
Seat 8: 1,1,2,3,5 ($26.60 in chips) 
Seat 9: Haek82 ($26.35 in chips) 
Seat 10: 1nyyfan ($42.90 in chips) 
MrKGBoreoman: posts small blind $0.25
w.t. spartan: posts big blind $0.50
*** HOLE CARDS ***
Dealt to 1,1,2,3,5 [Qh 8c]
OCbarrister: folds 
lamb1142: folds 
1,1,2,3,5: folds 
Haek82: calls $0.50
1nyyfan: folds 
JMAC60: folds 
JUNin: folds 
wpcrso: folds 
MrKGBoreoman: folds 
w.t. spartan: checks 
*** FLOP *** [6h 9d 4c]
w.t. spartan: checks 
Haek82: bets $0.50
w.t. spartan: calls $0.50
*** TURN *** [6h 9d 4c] [7h]
w.t. spartan: checks 
Haek82: bets $1
w.t. spartan: calls $1
*** RIVER *** [6h 9d 4c 7h] [Ah]
w.t. spartan: checks 
Haek82: bets $1
w.t. spartan: calls $1
*** SHOW DOWN ***
Haek82: shows [As 9c] (two pair, Aces and Nines)
w.t. spartan: mucks hand 
Haek82 collected $5.95 from pot
*** SUMMARY ***
Total pot $6.25 | Rake $0.30 
Board [6h 9d 4c 7h Ah]
Seat 1: JMAC60 folded before Flop (didn't bet)
Seat 2: JUNin folded before Flop (didn't bet)
Seat 3: wpcrso (button) folded before Flop (didn't bet)
Seat 4: MrKGBoreoman (small blind) folded before Flop
Seat 5: w.t. spartan (big blind) mucked [6s Tc]
Seat 6: OCbarrister folded before Flop (didn't bet)
Seat 7: lamb1142 folded before Flop (didn't bet)
Seat 8: 1,1,2,3,5 folded before Flop (didn't bet)
Seat 9: Haek82 showed [As 9c] and won ($5.95) with two pair, Aces and Nines
Seat 10: 1nyyfan folded before Flop (didn't bet)



PokerStars Game #6808835991:  Hold'em Limit ($0.50/$1.00) - 2006/10/28 - 22:31:46 (ET)
Table 'Tanina' 10-max Seat #4 is the button
Seat 1: JMAC60 ($27.05 in chips) 
Seat 2: JUNin ($12.50 in chips) 
Seat 3: wpcrso ($13.10 in chips) 
Seat 4: MrKGBoreoman ($18.35 in chips) 
Seat 5: w.t. spartan ($5 in chips) 
Seat 6: OCbarrister ($21.60 in chips) 
Seat 7: lamb1142 ($36.70 in chips) 
Seat 8: 1,1,2,3,5 ($26.60 in chips) 
Seat 9: Haek82 ($29.30 in chips) 
Seat 10: 1nyyfan ($42.90 in chips) 
w.t. spartan: posts small blind $0.25
OCbarrister: posts big blind $0.50
*** HOLE CARDS ***
Dealt to 1,1,2,3,5 [Qd 2h]
lamb1142: calls $0.50
1,1,2,3,5: folds 
Haek82: folds 
1nyyfan: calls $0.50
JMAC60: calls $0.50
JUNin: folds 
wpcrso: folds 
MrKGBoreoman: folds 
w.t. spartan: calls $0.25
OCbarrister: checks 
*** FLOP *** [7s Kc 8s]
w.t. spartan: checks 
OCbarrister: checks 
lamb1142: checks 
1nyyfan: checks 
JMAC60: bets $0.50
w.t. spartan: calls $0.50
OCbarrister: folds 
lamb1142: calls $0.50
1nyyfan: folds 
*** TURN *** [7s Kc 8s] [Tc]
w.t. spartan: checks 
lamb1142: checks 
JMAC60: bets $1
w.t. spartan: calls $1
lamb1142: folds 
*** RIVER *** [7s Kc 8s Tc] [Ks]
w.t. spartan: bets $1
JMAC60: raises $1 to $2
w.t. spartan: raises $1 to $3 and is all-in
JMAC60: calls $1
*** SHOW DOWN ***
w.t. spartan: shows [Ts Th] (a full house, Tens full of Kings)
JMAC60: shows [Td Kd] (a full house, Kings full of Tens)
JMAC60 collected $11.50 from pot
*** SUMMARY ***
Total pot $12 | Rake $0.50 
Board [7s Kc 8s Tc Ks]
Seat 1: JMAC60 showed [Td Kd] and won ($11.50) with a full house, Kings full of Tens
Seat 2: JUNin folded before Flop (didn't bet)
Seat 3: wpcrso folded before Flop (didn't bet)
Seat 4: MrKGBoreoman (button) folded before Flop (didn't bet)
Seat 5: w.t. spartan (small blind) showed [Ts Th] and lost with a full house, Tens full of Kings
Seat 6: OCbarrister (big blind) folded on the Flop
Seat 7: lamb1142 folded on the Turn
Seat 8: 1,1,2,3,5 folded before Flop (didn't bet)
Seat 9: Haek82 folded before Flop (didn't bet)
Seat 10: 1nyyfan folded on the Flop



PokerStars Game #6808854179:  Hold'em Limit ($0.50/$1.00) - 2006/10/28 - 22:33:03 (ET)
Table 'Tanina' 10-max Seat #6 is the button
Seat 1: JMAC60 ($33.55 in chips) 
Seat 2: JUNin ($12.50 in chips) 
Seat 3: wpcrso ($13.10 in chips) 
Seat 4: MrKGBoreoman ($18.35 in chips) 
Seat 6: OCbarrister ($21.10 in chips) 
Seat 7: lamb1142 ($35.70 in chips) 
Seat 8: 1,1,2,3,5 ($26.60 in chips) 
Seat 9: Haek82 ($29.30 in chips) 
Seat 10: 1nyyfan ($42.40 in chips) 
lamb1142: posts small blind $0.25
1,1,2,3,5: posts big blind $0.50
*** HOLE CARDS ***
Dealt to 1,1,2,3,5 [Js 3s]
Haek82: calls $0.50
1nyyfan: folds 
w.t. spartan leaves the table
JMAC60: folds 
JUNin: folds 
wpcrso: folds 
MrKGBoreoman: folds 
OCbarrister: calls $0.50
lamb1142: calls $0.25
1,1,2,3,5: checks 
*** FLOP *** [9c Jh Jd]
lamb1142: checks 
1,1,2,3,5: bets $0.50
call_me_pug joins the table at seat #5 
Haek82: calls $0.50
OCbarrister: calls $0.50
lamb1142: folds 
*** TURN *** [9c Jh Jd] [8c]
call_me_pug said, "...HIGH..and good day 2 all..."
1,1,2,3,5: bets $1
Haek82: calls $1
OCbarrister: folds 
*** RIVER *** [9c Jh Jd 8c] [6c]
1,1,2,3,5: bets $1
Haek82: folds 
1,1,2,3,5 collected $5.25 from pot
1,1,2,3,5: doesn't show hand 
*** SUMMARY ***
Total pot $5.50 | Rake $0.25 
Board [9c Jh Jd 8c 6c]
Seat 1: JMAC60 folded before Flop (didn't bet)
Seat 2: JUNin folded before Flop (didn't bet)
Seat 3: wpcrso folded before Flop (didn't bet)
Seat 4: MrKGBoreoman folded before Flop (didn't bet)
Seat 6: OCbarrister (button) folded on the Turn
Seat 7: lamb1142 (small blind) folded on the Flop
Seat 8: 1,1,2,3,5 (big blind) collected ($5.25)
Seat 9: Haek82 folded on the River
Seat 10: 1nyyfan folded before Flop (didn't bet)



PokerStars Game #6808866375:  Hold'em Limit ($0.50/$1.00) - 2006/10/28 - 22:33:55 (ET)
Table 'Tanina' 10-max Seat #7 is the button
Seat 1: JMAC60 ($33.55 in chips) 
Seat 2: JUNin ($12.50 in chips) 
Seat 3: wpcrso ($13.10 in chips) 
Seat 4: MrKGBoreoman ($18.35 in chips) 
Seat 5: call_me_pug ($20 in chips) 
Seat 6: OCbarrister ($20.10 in chips) 
Seat 7: lamb1142 ($35.20 in chips) 
Seat 8: 1,1,2,3,5 ($29.85 in chips) 
Seat 9: Haek82 ($27.30 in chips) 
Seat 10: 1nyyfan ($42.40 in chips) 
1,1,2,3,5: posts small blind $0.25
Haek82: posts big blind $0.50
call_me_pug: posts big blind $0.50
*** HOLE CARDS ***
Dealt to 1,1,2,3,5 [Td 8h]
1nyyfan: folds 
JMAC60: folds 
JUNin: folds 
wpcrso: folds 
MrKGBoreoman: raises $0.50 to $1
call_me_pug: folds 
OCbarrister: folds 
lamb1142: folds 
1,1,2,3,5: folds 
Haek82: calls $0.50
*** FLOP *** [9d Ah 8c]
Haek82: checks 
MrKGBoreoman: bets $0.50
Haek82: raises $0.50 to $1
MrKGBoreoman: calls $0.50
*** TURN *** [9d Ah 8c] [As]
Haek82: bets $1
MrKGBoreoman: calls $1
*** RIVER *** [9d Ah 8c As] [5c]
Haek82: bets $1
MrKGBoreoman: calls $1
*** SHOW DOWN ***
Haek82: shows [Qc Ts] (a pair of Aces)
MrKGBoreoman: shows [9h Kh] (two pair, Aces and Nines)
MrKGBoreoman collected $8.35 from pot
*** SUMMARY ***
Total pot $8.75 | Rake $0.40 
Board [9d Ah 8c As 5c]
Seat 1: JMAC60 folded before Flop (didn't bet)
Seat 2: JUNin folded before Flop (didn't bet)
Seat 3: wpcrso folded before Flop (didn't bet)
Seat 4: MrKGBoreoman showed [9h Kh] and won ($8.35) with two pair, Aces and Nines
Seat 5: call_me_pug folded before Flop
Seat 6: OCbarrister folded before Flop (didn't bet)
Seat 7: lamb1142 (button) folded before Flop (didn't bet)
Seat 8: 1,1,2,3,5 (small blind) folded before Flop
Seat 9: Haek82 (big blind) showed [Qc Ts] and lost with a pair of Aces
Seat 10: 1nyyfan folded before Flop (didn't bet)



PokerStars Game #6808883890:  Hold'em Limit ($0.50/$1.00) - 2006/10/28 - 22:35:10 (ET)
Table 'Tanina' 10-max Seat #8 is the button
Seat 1: JMAC60 ($33.55 in chips) 
Seat 2: JUNin ($12.50 in chips) 
Seat 3: wpcrso ($13.10 in chips) 
Seat 4: MrKGBoreoman ($22.70 in chips) 
Seat 5: call_me_pug ($19.50 in chips) 
Seat 6: OCbarrister ($20.10 in chips) 
Seat 7: lamb1142 ($35.20 in chips) 
Seat 8: 1,1,2,3,5 ($29.60 in chips) 
Seat 9: Haek82 ($23.30 in chips) 
Seat 10: 1nyyfan ($42.40 in chips) 
Haek82: posts small blind $0.25
1nyyfan: posts big blind $0.50
*** HOLE CARDS ***
Dealt to 1,1,2,3,5 [4c 5s]
JMAC60: folds 
JUNin: folds 
wpcrso: folds 
MrKGBoreoman: folds 
call_me_pug: folds 
OCbarrister: calls $0.50
lamb1142: folds 
1,1,2,3,5: folds 
Haek82: folds 
1nyyfan: checks 
*** FLOP *** [5c 8d 4d]
1nyyfan: checks 
OCbarrister: checks 
*** TURN *** [5c 8d 4d] [8h]
1nyyfan: checks 
OCbarrister: checks 
*** RIVER *** [5c 8d 4d 8h] [2c]
1nyyfan: checks 
OCbarrister: checks 
*** SHOW DOWN ***
1nyyfan: shows [Jc 4h] (two pair, Eights and Fours)
OCbarrister: mucks hand 
1nyyfan collected $1.20 from pot
*** SUMMARY ***
Total pot $1.25 | Rake $0.05 
Board [5c 8d 4d 8h 2c]
Seat 1: JMAC60 folded before Flop (didn't bet)
Seat 2: JUNin folded before Flop (didn't bet)
Seat 3: wpcrso folded before Flop (didn't bet)
Seat 4: MrKGBoreoman folded before Flop (didn't bet)
Seat 5: call_me_pug folded before Flop (didn't bet)
Seat 6: OCbarrister mucked [Qd 9h]
Seat 7: lamb1142 folded before Flop (didn't bet)
Seat 8: 1,1,2,3,5 (button) folded before Flop (didn't bet)
Seat 9: Haek82 (small blind) folded before Flop
Seat 10: 1nyyfan (big blind) showed [Jc 4h] and won ($1.20) with two pair, Eights and Fours



PokerStars Game #6808891717:  Hold'em Limit ($0.50/$1.00) - 2006/10/28 - 22:35:44 (ET)
Table 'Tanina' 10-max Seat #9 is the button
Seat 1: JMAC60 ($33.55 in chips) 
Seat 2: JUNin ($12.50 in chips) 
Seat 3: wpcrso ($13.10 in chips) 
Seat 4: MrKGBoreoman ($22.70 in chips) 
Seat 5: call_me_pug ($19.50 in chips) 
Seat 6: OCbarrister ($19.60 in chips) 
Seat 7: lamb1142 ($35.20 in chips) 
Seat 8: 1,1,2,3,5 ($29.60 in chips) 
Seat 9: Haek82 ($23.05 in chips) 
Seat 10: 1nyyfan ($43.10 in chips) 
1nyyfan: posts small blind $0.25
JMAC60: posts big blind $0.50
*** HOLE CARDS ***
Dealt to 1,1,2,3,5 [Jh 8d]
JUNin: raises $0.50 to $1
wpcrso: folds 
MrKGBoreoman: folds 
call_me_pug: folds 
OCbarrister: folds 
lamb1142: folds 
1,1,2,3,5: folds 
Haek82: folds 
1nyyfan: folds 
JMAC60: folds 
JUNin collected $1.25 from pot
*** SUMMARY ***
Total pot $1.25 | Rake $0 
Seat 1: JMAC60 (big blind) folded before Flop
Seat 2: JUNin collected ($1.25)
Seat 3: wpcrso folded before Flop (didn't bet)
Seat 4: MrKGBoreoman folded before Flop (didn't bet)
Seat 5: call_me_pug folded before Flop (didn't bet)
Seat 6: OCbarrister folded before Flop (didn't bet)
Seat 7: lamb1142 folded before Flop (didn't bet)
Seat 8: 1,1,2,3,5 folded before Flop (didn't bet)
Seat 9: Haek82 (button) folded before Flop (didn't bet)
Seat 10: 1nyyfan (small blind) folded before Flop



PokerStars Game #6808899107:  Hold'em Limit ($0.50/$1.00) - 2006/10/28 - 22:36:17 (ET)
Table 'Tanina' 10-max Seat #10 is the button
Seat 1: JMAC60 ($33.05 in chips) 
Seat 2: JUNin ($13.25 in chips) 
Seat 3: wpcrso ($13.10 in chips) 
Seat 4: MrKGBoreoman ($22.70 in chips) 
Seat 5: call_me_pug ($19.50 in chips) 
Seat 6: OCbarrister ($19.60 in chips) 
Seat 7: lamb1142 ($35.20 in chips) 
Seat 8: 1,1,2,3,5 ($29.60 in chips) 
Seat 9: Haek82 ($23.05 in chips) 
Seat 10: 1nyyfan ($42.85 in chips) 
JMAC60: posts small blind $0.25
JUNin: posts big blind $0.50
*** HOLE CARDS ***
Dealt to 1,1,2,3,5 [7h Js]
wpcrso: folds 
MrKGBoreoman: folds 
call_me_pug: calls $0.50
OCbarrister: folds 
lamb1142: calls $0.50
1,1,2,3,5: folds 
Haek82: folds 
1nyyfan: folds 
JMAC60: calls $0.25
JUNin: checks 
*** FLOP *** [Jd Ac 3c]
JMAC60: checks 
JUNin: checks 
call_me_pug: checks 
lamb1142: checks 
*** TURN *** [Jd Ac 3c] [9d]
JMAC60: checks 
JUNin: checks 
call_me_pug: bets $1
lamb1142: folds 
JMAC60: folds 
JUNin: folds 
call_me_pug collected $1.90 from pot
*** SUMMARY ***
Total pot $2 | Rake $0.10 
Board [Jd Ac 3c 9d]
Seat 1: JMAC60 (small blind) folded on the Turn
Seat 2: JUNin (big blind) folded on the Turn
Seat 3: wpcrso folded before Flop (didn't bet)
Seat 4: MrKGBoreoman folded before Flop (didn't bet)
Seat 5: call_me_pug collected ($1.90)
Seat 6: OCbarrister folded before Flop (didn't bet)
Seat 7: lamb1142 folded on the Turn
Seat 8: 1,1,2,3,5 folded before Flop (didn't bet)
Seat 9: Haek82 folded before Flop (didn't bet)
Seat 10: 1nyyfan (button) folded before Flop (didn't bet)



PokerStars Game #6808917022:  Hold'em Limit ($0.50/$1.00) - 2006/10/28 - 22:37:34 (ET)
Table 'Tanina' 10-max Seat #1 is the button
Seat 1: JMAC60 ($32.55 in chips) 
Seat 2: JUNin ($12.75 in chips) 
Seat 3: wpcrso ($13.10 in chips) 
Seat 4: MrKGBoreoman ($22.70 in chips) 
Seat 5: call_me_pug ($20.90 in chips) 
Seat 6: OCbarrister ($19.60 in chips) 
Seat 7: lamb1142 ($34.70 in chips) 
Seat 8: 1,1,2,3,5 ($29.60 in chips) 
Seat 9: Haek82 ($23.05 in chips) 
Seat 10: 1nyyfan ($42.85 in chips) 
JUNin: posts small blind $0.25
wpcrso: posts big blind $0.50
*** HOLE CARDS ***
Dealt to 1,1,2,3,5 [2c Tc]
MrKGBoreoman: folds 
call_me_pug: folds 
OCbarrister: calls $0.50
lamb1142: calls $0.50
1,1,2,3,5: folds 
Haek82: calls $0.50
1nyyfan: folds 
JMAC60: folds 
JMAC60 is sitting out
JUNin: folds 
wpcrso: checks 
*** FLOP *** [Ah Kh Kc]
wpcrso: checks 
OCbarrister: checks 
lamb1142: checks 
Haek82: checks 
*** TURN *** [Ah Kh Kc] [Jh]
wpcrso: checks 
OCbarrister: checks 
lamb1142: checks 
Haek82: bets $1
wpcrso: folds 
OCbarrister: folds 
lamb1142: calls $1
*** RIVER *** [Ah Kh Kc Jh] [3c]
JMAC60 has returned
lamb1142: checks 
Haek82: checks 
*** SHOW DOWN ***
lamb1142: shows [Js Ts] (two pair, Kings and Jacks)
Haek82: shows [As 7h] (two pair, Aces and Kings)
Haek82 collected $4.05 from pot
*** SUMMARY ***
Total pot $4.25 | Rake $0.20 
Board [Ah Kh Kc Jh 3c]
Seat 1: JMAC60 (button) folded before Flop (didn't bet)
Seat 2: JUNin (small blind) folded before Flop
Seat 3: wpcrso (big blind) folded on the Turn
Seat 4: MrKGBoreoman folded before Flop (didn't bet)
Seat 5: call_me_pug folded before Flop (didn't bet)
Seat 6: OCbarrister folded on the Turn
Seat 7: lamb1142 showed [Js Ts] and lost with two pair, Kings and Jacks
Seat 8: 1,1,2,3,5 folded before Flop (didn't bet)
Seat 9: Haek82 showed [As 7h] and won ($4.05) with two pair, Aces and Kings
Seat 10: 1nyyfan folded before Flop (didn't bet)



PokerStars Game #6808929684:  Hold'em Limit ($0.50/$1.00) - 2006/10/28 - 22:38:29 (ET)
Table 'Tanina' 10-max Seat #2 is the button
Seat 1: JMAC60 ($32.55 in chips) 
Seat 2: JUNin ($12.50 in chips) 
Seat 3: wpcrso ($12.60 in chips) 
Seat 4: MrKGBoreoman ($22.70 in chips) 
Seat 5: call_me_pug ($20.90 in chips) 
Seat 6: OCbarrister ($19.10 in chips) 
Seat 7: lamb1142 ($33.20 in chips) 
Seat 8: 1,1,2,3,5 ($29.60 in chips) 
Seat 9: Haek82 ($25.60 in chips) 
Seat 10: 1nyyfan ($42.85 in chips) 
wpcrso: posts small blind $0.25
MrKGBoreoman: posts big blind $0.50
*** HOLE CARDS ***
Dealt to 1,1,2,3,5 [Ah 9s]
call_me_pug: calls $0.50
OCbarrister: folds 
lamb1142: folds 
1,1,2,3,5: folds 
Haek82: calls $0.50
1nyyfan: folds 
JMAC60: calls $0.50
JUNin: folds 
wpcrso: calls $0.25
MrKGBoreoman: checks 
*** FLOP *** [8d Ac 7h]
wpcrso: checks 
MrKGBoreoman: checks 
call_me_pug: bets $0.50
Haek82: folds 
JMAC60: calls $0.50
wpcrso: folds 
MrKGBoreoman: calls $0.50
*** TURN *** [8d Ac 7h] [7s]
MrKGBoreoman: checks 
call_me_pug: bets $1
JMAC60: folds 
MrKGBoreoman: calls $1
*** RIVER *** [8d Ac 7h 7s] [6h]
MrKGBoreoman: checks 
call_me_pug: bets $1
MrKGBoreoman: calls $1
*** SHOW DOWN ***
call_me_pug: shows [8h 8s] (a full house, Eights full of Sevens)
MrKGBoreoman: mucks hand 
call_me_pug collected $7.65 from pot
*** SUMMARY ***
Total pot $8 | Rake $0.35 
Board [8d Ac 7h 7s 6h]
Seat 1: JMAC60 folded on the Turn
Seat 2: JUNin (button) folded before Flop (didn't bet)
Seat 3: wpcrso (small blind) folded on the Flop
Seat 4: MrKGBoreoman (big blind) mucked [4h As]
Seat 5: call_me_pug showed [8h 8s] and won ($7.65) with a full house, Eights full of Sevens
Seat 6: OCbarrister folded before Flop (didn't bet)
Seat 7: lamb1142 folded before Flop (didn't bet)
Seat 8: 1,1,2,3,5 folded before Flop (didn't bet)
Seat 9: Haek82 folded on the Flop
Seat 10: 1nyyfan folded before Flop (didn't bet)



PokerStars Game #6808946929:  Hold'em Limit ($0.50/$1.00) - 2006/10/28 - 22:39:45 (ET)
Table 'Tanina' 10-max Seat #3 is the button
Seat 1: JMAC60 ($31.55 in chips) 
Seat 2: JUNin ($12.50 in chips) 
Seat 3: wpcrso ($12.10 in chips) 
Seat 4: MrKGBoreoman ($19.70 in chips) 
Seat 5: call_me_pug ($25.55 in chips) 
Seat 6: OCbarrister ($19.10 in chips) 
Seat 7: lamb1142 ($33.20 in chips) 
Seat 8: 1,1,2,3,5 ($29.60 in chips) 
Seat 9: Haek82 ($25.10 in chips) 
Seat 10: 1nyyfan ($42.85 in chips) 
MrKGBoreoman: posts small blind $0.25
call_me_pug: posts big blind $0.50
*** HOLE CARDS ***
Dealt to 1,1,2,3,5 [5h 3d]
OCbarrister: folds 
lamb1142: folds 
1,1,2,3,5: folds 
Haek82: folds 
1nyyfan: folds 
JMAC60: folds 
JUNin: folds 
wpcrso: folds 
MrKGBoreoman: folds 
call_me_pug collected $0.50 from pot
call_me_pug: doesn't show hand 
*** SUMMARY ***
Total pot $0.50 | Rake $0 
Seat 1: JMAC60 folded before Flop (didn't bet)
Seat 2: JUNin folded before Flop (didn't bet)
Seat 3: wpcrso (button) folded before Flop (didn't bet)
Seat 4: MrKGBoreoman (small blind) folded before Flop
Seat 5: call_me_pug (big blind) collected ($0.50)
Seat 6: OCbarrister folded before Flop (didn't bet)
Seat 7: lamb1142 folded before Flop (didn't bet)
Seat 8: 1,1,2,3,5 folded before Flop (didn't bet)
Seat 9: Haek82 folded before Flop (didn't bet)
Seat 10: 1nyyfan folded before Flop (didn't bet)



PokerStars Game #6808952078:  Hold'em Limit ($0.50/$1.00) - 2006/10/28 - 22:40:07 (ET)
Table 'Tanina' 10-max Seat #4 is the button
Seat 1: JMAC60 ($31.55 in chips) 
Seat 2: JUNin ($12.50 in chips) 
Seat 3: wpcrso ($12.10 in chips) 
Seat 4: MrKGBoreoman ($19.45 in chips) 
Seat 5: call_me_pug ($25.80 in chips) 
Seat 6: OCbarrister ($19.10 in chips) 
Seat 7: lamb1142 ($33.20 in chips) 
Seat 8: 1,1,2,3,5 ($29.60 in chips) 
Seat 9: Haek82 ($25.10 in chips) 
Seat 10: 1nyyfan ($42.85 in chips) 
call_me_pug: posts small blind $0.25
OCbarrister: posts big blind $0.50
*** HOLE CARDS ***
Dealt to 1,1,2,3,5 [3c 4s]
lamb1142: folds 
1,1,2,3,5: folds 
Haek82: folds 
1nyyfan: calls $0.50
JMAC60: folds 
JUNin: folds 
wpcrso: calls $0.50
lamb1142 leaves the table
MrKGBoreoman: folds 
call_me_pug: calls $0.25
OCbarrister: checks 
*** FLOP *** [8d Jh Kd]
call_me_pug: checks 
OCbarrister: checks 
1nyyfan: bets $0.50
wpcrso: folds 
call_me_pug: calls $0.50
OCbarrister: folds 
*** TURN *** [8d Jh Kd] [2d]
call_me_pug: checks 
1nyyfan: checks 
*** RIVER *** [8d Jh Kd 2d] [3s]
call_me_pug: bets $1
1nyyfan: calls $1
*** SHOW DOWN ***
call_me_pug: shows [4d 9d] (a flush, King high)
1nyyfan: mucks hand 
call_me_pug collected $4.80 from pot
*** SUMMARY ***
Total pot $5 | Rake $0.20 
Board [8d Jh Kd 2d 3s]
Seat 1: JMAC60 folded before Flop (didn't bet)
Seat 2: JUNin folded before Flop (didn't bet)
Seat 3: wpcrso folded on the Flop
Seat 4: MrKGBoreoman (button) folded before Flop (didn't bet)
Seat 5: call_me_pug (small blind) showed [4d 9d] and won ($4.80) with a flush, King high
Seat 6: OCbarrister (big blind) folded on the Flop
Seat 7: lamb1142 folded before Flop (didn't bet)
Seat 8: 1,1,2,3,5 folded before Flop (didn't bet)
Seat 9: Haek82 folded before Flop (didn't bet)
Seat 10: 1nyyfan mucked [Kc Th]



PokerStars Game #6808964303:  Hold'em Limit ($0.50/$1.00) - 2006/10/28 - 22:41:01 (ET)
Table 'Tanina' 10-max Seat #5 is the button
Seat 1: JMAC60 ($31.55 in chips) 
Seat 2: JUNin ($12.50 in chips) 
Seat 3: wpcrso ($11.60 in chips) 
Seat 4: MrKGBoreoman ($19.45 in chips) 
Seat 5: call_me_pug ($28.60 in chips) 
Seat 6: OCbarrister ($18.60 in chips) 
Seat 8: 1,1,2,3,5 ($29.60 in chips) 
Seat 9: Haek82 ($25.10 in chips) 
Seat 10: 1nyyfan ($40.85 in chips) 
OCbarrister: posts small blind $0.25
1,1,2,3,5: posts big blind $0.50
*** HOLE CARDS ***
Dealt to 1,1,2,3,5 [As 5h]
Haek82: folds 
1nyyfan: folds 
JMAC60: calls $0.50
JUNin: folds 
wpcrso: folds 
MrKGBoreoman: folds 
call_me_pug: folds 
OCbarrister: calls $0.25
1,1,2,3,5: checks 
*** FLOP *** [6c 7c Kc]
OCbarrister: checks 
1,1,2,3,5: checks 
JMAC60: bets $0.50
OCbarrister: folds 
1,1,2,3,5: folds 
JMAC60 collected $1.45 from pot
JMAC60: doesn't show hand 
*** SUMMARY ***
Total pot $1.50 | Rake $0.05 
Board [6c 7c Kc]
Seat 1: JMAC60 collected ($1.45)
Seat 2: JUNin folded before Flop (didn't bet)
Seat 3: wpcrso folded before Flop (didn't bet)
Seat 4: MrKGBoreoman folded before Flop (didn't bet)
Seat 5: call_me_pug (button) folded before Flop (didn't bet)
Seat 6: OCbarrister (small blind) folded on the Flop
Seat 8: 1,1,2,3,5 (big blind) folded on the Flop
Seat 9: Haek82 folded before Flop (didn't bet)
Seat 10: 1nyyfan folded before Flop (didn't bet)



PokerStars Game #6808970972:  Hold'em Limit ($0.50/$1.00) - 2006/10/28 - 22:41:29 (ET)
Table 'Tanina' 10-max Seat #6 is the button
Seat 1: JMAC60 ($32.50 in chips) 
Seat 2: JUNin ($12.50 in chips) 
Seat 3: wpcrso ($11.60 in chips) 
Seat 4: MrKGBoreoman ($19.45 in chips) 
Seat 5: call_me_pug ($28.60 in chips) 
Seat 6: OCbarrister ($18.10 in chips) 
Seat 8: 1,1,2,3,5 ($29.10 in chips) 
Seat 9: Haek82 ($25.10 in chips) 
Seat 10: 1nyyfan ($40.85 in chips) 
1,1,2,3,5: posts small blind $0.25
Haek82: posts big blind $0.50
*** HOLE CARDS ***
Dealt to 1,1,2,3,5 [5h As]
1nyyfan: folds 
JMAC60: folds 
JUNin: folds 
wpcrso: folds 
MrKGBoreoman: folds 
call_me_pug: calls $0.50
OCbarrister: calls $0.50
1,1,2,3,5: folds 
Haek82: checks 
*** FLOP *** [Kh 9d Jh]
Moooose joins the table at seat #7 
Haek82: checks 
call_me_pug: bets $0.50
OCbarrister: folds 
Haek82: calls $0.50
*** TURN *** [Kh 9d Jh] [6c]
Haek82: checks 
call_me_pug: bets $1
Haek82: calls $1
*** RIVER *** [Kh 9d Jh 6c] [Td]
Haek82: checks 
call_me_pug: bets $1
Haek82: calls $1
*** SHOW DOWN ***
call_me_pug: shows [Th Qd] (a straight, Nine to King)
Haek82: mucks hand 
call_me_pug collected $6.45 from pot
*** SUMMARY ***
Total pot $6.75 | Rake $0.30 
Board [Kh 9d Jh 6c Td]
Seat 1: JMAC60 folded before Flop (didn't bet)
Seat 2: JUNin folded before Flop (didn't bet)
Seat 3: wpcrso folded before Flop (didn't bet)
Seat 4: MrKGBoreoman folded before Flop (didn't bet)
Seat 5: call_me_pug showed [Th Qd] and won ($6.45) with a straight, Nine to King
Seat 6: OCbarrister (button) folded on the Flop
Seat 8: 1,1,2,3,5 (small blind) folded before Flop
Seat 9: Haek82 (big blind) mucked [3c Ks]
Seat 10: 1nyyfan folded before Flop (didn't bet)



PokerStars Game #6808981081:  Hold'em Limit ($0.50/$1.00) - 2006/10/28 - 22:42:13 (ET)
Table 'Tanina' 10-max Seat #8 is the button
Seat 1: JMAC60 ($32.50 in chips) 
Seat 2: JUNin ($12.50 in chips) 
Seat 3: wpcrso ($11.60 in chips) 
Seat 4: MrKGBoreoman ($19.45 in chips) 
Seat 5: call_me_pug ($32.05 in chips) 
Seat 6: OCbarrister ($17.60 in chips) 
Seat 7: Moooose ($18.75 in chips) 
Seat 8: 1,1,2,3,5 ($28.85 in chips) 
Seat 9: Haek82 ($22.10 in chips) 
Seat 10: 1nyyfan ($40.85 in chips) 
Haek82: posts small blind $0.25
1nyyfan: posts big blind $0.50
Moooose: posts big blind $0.50
*** HOLE CARDS ***
Dealt to 1,1,2,3,5 [6s 5d]
JMAC60: calls $0.50
JUNin: folds 
wpcrso: folds 
MrKGBoreoman: folds 
call_me_pug: calls $0.50
OCbarrister: folds 
Moooose: checks 
1,1,2,3,5: folds 
Haek82: calls $0.25
1nyyfan: checks 
*** FLOP *** [6c Ts Kh]
Haek82: checks 
1nyyfan: checks 
JMAC60: bets $0.50
call_me_pug: calls $0.50
Moooose: folds 
Haek82: folds 
1nyyfan: calls $0.50
*** TURN *** [6c Ts Kh] [5c]
1nyyfan: checks 
JMAC60: bets $1
call_me_pug: folds 
1nyyfan: folds 
JMAC60 collected $3.85 from pot
JMAC60: doesn't show hand 
*** SUMMARY ***
Total pot $4 | Rake $0.15 
Board [6c Ts Kh 5c]
Seat 1: JMAC60 collected ($3.85)
Seat 2: JUNin folded before Flop (didn't bet)
Seat 3: wpcrso folded before Flop (didn't bet)
Seat 4: MrKGBoreoman folded before Flop (didn't bet)
Seat 5: call_me_pug folded on the Turn
Seat 6: OCbarrister folded before Flop (didn't bet)
Seat 7: Moooose folded on the Flop
Seat 8: 1,1,2,3,5 (button) folded before Flop (didn't bet)
Seat 9: Haek82 (small blind) folded on the Flop
Seat 10: 1nyyfan (big blind) folded on the Turn



PokerStars Game #6808992936:  Hold'em Limit ($0.50/$1.00) - 2006/10/28 - 22:43:05 (ET)
Table 'Tanina' 10-max Seat #9 is the button
Seat 1: JMAC60 ($35.35 in chips) 
Seat 2: JUNin ($12.50 in chips) 
Seat 3: wpcrso ($11.60 in chips) 
Seat 4: MrKGBoreoman ($19.45 in chips) 
Seat 5: call_me_pug ($31.05 in chips) 
Seat 6: OCbarrister ($17.60 in chips) 
Seat 7: Moooose ($18.25 in chips) 
Seat 8: 1,1,2,3,5 ($28.85 in chips) 
Seat 9: Haek82 ($21.60 in chips) 
Seat 10: 1nyyfan ($39.85 in chips) 
1nyyfan: posts small blind $0.25
JMAC60: posts big blind $0.50
*** HOLE CARDS ***
Dealt to 1,1,2,3,5 [Qd 7d]
JUNin: folds 
wpcrso: folds 
MrKGBoreoman: folds 
call_me_pug: folds 
OCbarrister: calls $0.50
Moooose: folds 
1,1,2,3,5: folds 
Haek82: folds 
1nyyfan: calls $0.25
JMAC60: checks 
*** FLOP *** [5c Ah 7s]
1nyyfan: checks 
JMAC60: checks 
OCbarrister: checks 
*** TURN *** [5c Ah 7s] [6d]
1nyyfan: checks 
JMAC60: checks 
OCbarrister: checks 
*** RIVER *** [5c Ah 7s 6d] [4h]
1nyyfan: checks 
JMAC60: checks 
OCbarrister: checks 
*** SHOW DOWN ***
1nyyfan: shows [3s Ad] (a straight, Three to Seven)
JMAC60: mucks hand 
OCbarrister: mucks hand 
1nyyfan collected $1.45 from pot
*** SUMMARY ***
Total pot $1.50 | Rake $0.05 
Board [5c Ah 7s 6d 4h]
Seat 1: JMAC60 (big blind) mucked [Jc Ts]
Seat 2: JUNin folded before Flop (didn't bet)
Seat 3: wpcrso folded before Flop (didn't bet)
Seat 4: MrKGBoreoman folded before Flop (didn't bet)
Seat 5: call_me_pug folded before Flop (didn't bet)
Seat 6: OCbarrister mucked [Qs 9d]
Seat 7: Moooose folded before Flop (didn't bet)
Seat 8: 1,1,2,3,5 folded before Flop (didn't bet)
Seat 9: Haek82 (button) folded before Flop (didn't bet)
Seat 10: 1nyyfan (small blind) showed [3s Ad] and won ($1.45) with a straight, Three to Seven



PokerStars Game #6809002753:  Hold'em Limit ($0.50/$1.00) - 2006/10/28 - 22:43:48 (ET)
Table 'Tanina' 10-max Seat #10 is the button
Seat 1: JMAC60 ($34.85 in chips) 
Seat 2: JUNin ($12.50 in chips) 
Seat 3: wpcrso ($11.60 in chips) 
Seat 4: MrKGBoreoman ($19.45 in chips) 
Seat 5: call_me_pug ($31.05 in chips) 
Seat 6: OCbarrister ($17.10 in chips) 
Seat 7: Moooose ($18.25 in chips) 
Seat 8: 1,1,2,3,5 ($28.85 in chips) 
Seat 9: Haek82 ($21.60 in chips) 
Seat 10: 1nyyfan ($40.80 in chips) 
JMAC60: posts small blind $0.25
JUNin: posts big blind $0.50
*** HOLE CARDS ***
Dealt to 1,1,2,3,5 [3h Jc]
wpcrso: folds 
MrKGBoreoman: folds 
call_me_pug: folds 
OCbarrister: calls $0.50
Moooose: folds 
1,1,2,3,5: folds 
Haek82: calls $0.50
1nyyfan: folds 
JMAC60: calls $0.25
JUNin: raises $0.50 to $1
OCbarrister: calls $0.50
Haek82: calls $0.50
JMAC60: calls $0.50
*** FLOP *** [Ah 7d Kc]
JMAC60: checks 
JUNin: bets $0.50
OCbarrister: raises $0.50 to $1
Haek82: folds 
JMAC60: folds 
JUNin: raises $0.50 to $1.50
OCbarrister: calls $0.50
*** TURN *** [Ah 7d Kc] [6h]
JUNin has timed out
JUNin: folds 
JUNin is sitting out
OCbarrister collected $6.70 from pot
OCbarrister: shows [7h 7c] (three of a kind, Sevens)
*** SUMMARY ***
Total pot $7 | Rake $0.30 
Board [Ah 7d Kc 6h]
Seat 1: JMAC60 (small blind) folded on the Flop
Seat 2: JUNin (big blind) folded on the Turn
Seat 3: wpcrso folded before Flop (didn't bet)
Seat 4: MrKGBoreoman folded before Flop (didn't bet)
Seat 5: call_me_pug folded before Flop (didn't bet)
Seat 6: OCbarrister collected ($6.70)
Seat 7: Moooose folded before Flop (didn't bet)
Seat 8: 1,1,2,3,5 folded before Flop (didn't bet)
Seat 9: Haek82 folded on the Flop
Seat 10: 1nyyfan (button) folded before Flop (didn't bet)



PokerStars Game #6809020059:  Hold'em Limit ($0.50/$1.00) - 2006/10/28 - 22:45:04 (ET)
Table 'Tanina' 10-max Seat #1 is the button
Seat 1: JMAC60 ($33.85 in chips) 
Seat 3: wpcrso ($11.60 in chips) 
Seat 4: MrKGBoreoman ($19.45 in chips) 
Seat 5: call_me_pug ($31.05 in chips) 
Seat 6: OCbarrister ($21.30 in chips) 
Seat 7: Moooose ($18.25 in chips) 
Seat 8: 1,1,2,3,5 ($28.85 in chips) 
Seat 9: Haek82 ($20.60 in chips) 
Seat 10: 1nyyfan ($40.80 in chips) 
wpcrso: posts small blind $0.25
MrKGBoreoman: posts big blind $0.50
*** HOLE CARDS ***
Dealt to 1,1,2,3,5 [Jc 3c]
call_me_pug: folds 
OCbarrister: raises $0.50 to $1
Moooose: folds 
1,1,2,3,5: folds 
Haek82: folds 
1nyyfan: calls $1
JMAC60: folds 
wpcrso: folds 
MrKGBoreoman: folds 
*** FLOP *** [6s Jd Td]
OCbarrister: bets $0.50
1nyyfan: calls $0.50
*** TURN *** [6s Jd Td] [Ad]
OCbarrister: bets $1
1nyyfan: raises $1 to $2
OCbarrister: raises $1 to $3
1nyyfan: calls $1
*** RIVER *** [6s Jd Td Ad] [2s]
OCbarrister: bets $1
1nyyfan: raises $1 to $2
OCbarrister: calls $1
*** SHOW DOWN ***
1nyyfan: shows [Qh Kd] (a straight, Ten to Ace)
OCbarrister: mucks hand 
1nyyfan collected $13.25 from pot
*** SUMMARY ***
Total pot $13.75 | Rake $0.50 
Board [6s Jd Td Ad 2s]
Seat 1: JMAC60 (button) folded before Flop (didn't bet)
Seat 3: wpcrso (small blind) folded before Flop
Seat 4: MrKGBoreoman (big blind) folded before Flop
Seat 5: call_me_pug folded before Flop (didn't bet)
Seat 6: OCbarrister mucked [As Ac]
Seat 7: Moooose folded before Flop (didn't bet)
Seat 8: 1,1,2,3,5 folded before Flop (didn't bet)
Seat 9: Haek82 folded before Flop (didn't bet)
Seat 10: 1nyyfan showed [Qh Kd] and won ($13.25) with a straight, Ten to Ace



PokerStars Game #6809030032:  Hold'em Limit ($0.50/$1.00) - 2006/10/28 - 22:45:48 (ET)
Table 'Tanina' 10-max Seat #3 is the button
Seat 1: JMAC60 ($33.85 in chips) 
Seat 3: wpcrso ($11.35 in chips) 
Seat 4: MrKGBoreoman ($18.95 in chips) 
Seat 5: call_me_pug ($31.05 in chips) 
Seat 6: OCbarrister ($14.80 in chips) 
Seat 7: Moooose ($18.25 in chips) 
Seat 8: 1,1,2,3,5 ($28.85 in chips) 
Seat 9: Haek82 ($20.60 in chips) 
Seat 10: 1nyyfan ($47.55 in chips) 
MrKGBoreoman: posts small blind $0.25
call_me_pug: posts big blind $0.50
*** HOLE CARDS ***
Dealt to 1,1,2,3,5 [Td 7d]
OCbarrister: folds 
Moooose: folds 
1,1,2,3,5: folds 
Haek82: raises $0.50 to $1
1nyyfan: folds 
JMAC60: folds 
wpcrso: folds 
MrKGBoreoman: folds 
call_me_pug: calls $0.50
*** FLOP *** [Kd Qd Js]
OCbarrister said, "three A's-  nice hand- I was hoping I wouldn't see the K/Q"
call_me_pug: checks 
Haek82: bets $0.50
call_me_pug: calls $0.50
*** TURN *** [Kd Qd Js] [6d]
call_me_pug: checks 
Haek82: checks 
*** RIVER *** [Kd Qd Js 6d] [Jd]
call_me_pug: bets $1
Haek82: folds 
call_me_pug collected $3.10 from pot
*** SUMMARY ***
Total pot $3.25 | Rake $0.15 
Board [Kd Qd Js 6d Jd]
Seat 1: JMAC60 folded before Flop (didn't bet)
Seat 3: wpcrso (button) folded before Flop (didn't bet)
Seat 4: MrKGBoreoman (small blind) folded before Flop
Seat 5: call_me_pug (big blind) collected ($3.10)
Seat 6: OCbarrister folded before Flop (didn't bet)
Seat 7: Moooose folded before Flop (didn't bet)
Seat 8: 1,1,2,3,5 folded before Flop (didn't bet)
Seat 9: Haek82 folded on the River
Seat 10: 1nyyfan folded before Flop (didn't bet)



PokerStars Game #6809041148:  Hold'em Limit ($0.50/$1.00) - 2006/10/28 - 22:46:37 (ET)
Table 'Tanina' 10-max Seat #4 is the button
Seat 1: JMAC60 ($33.85 in chips) 
Seat 3: wpcrso ($11.35 in chips) 
Seat 4: MrKGBoreoman ($18.70 in chips) 
Seat 5: call_me_pug ($32.65 in chips) 
Seat 6: OCbarrister ($14.80 in chips) 
Seat 7: Moooose ($18.25 in chips) 
Seat 8: 1,1,2,3,5 ($28.85 in chips) 
Seat 9: Haek82 ($19.10 in chips) 
Seat 10: 1nyyfan ($47.55 in chips) 
call_me_pug: posts small blind $0.25
OCbarrister: posts big blind $0.50
*** HOLE CARDS ***
Dealt to 1,1,2,3,5 [Ah 2h]
Haek82 said, "flush?"
Moooose: folds 
1,1,2,3,5: folds 
Haek82: folds 
1nyyfan: folds 
JMAC60: calls $0.50
call_me_pug said, "didnt show..?"
wpcrso: folds 
MrKGBoreoman: folds 
call_me_pug: calls $0.25
OCbarrister: checks 
*** FLOP *** [7h 8d Ac]
call_me_pug: checks 
OCbarrister: checks 
call_me_pug said, "...A 10..flop str..nut flush..on river.."
JMAC60: bets $0.50
call_me_pug: calls $0.50
OCbarrister: calls $0.50
*** TURN *** [7h 8d Ac] [As]
OCbarrister said, "Nope  I tried to show but it cut me off"
call_me_pug: checks 
OCbarrister: bets $1
JMAC60: folds 
call_me_pug: folds 
OCbarrister collected $2.90 from pot
OCbarrister: shows [Ad Qh] (three of a kind, Aces)
*** SUMMARY ***
Total pot $3 | Rake $0.10 
Board [7h 8d Ac As]
Seat 1: JMAC60 folded on the Turn
Seat 3: wpcrso folded before Flop (didn't bet)
Seat 4: MrKGBoreoman (button) folded before Flop (didn't bet)
Seat 5: call_me_pug (small blind) folded on the Turn
Seat 6: OCbarrister (big blind) collected ($2.90)
Seat 7: Moooose folded before Flop (didn't bet)
Seat 8: 1,1,2,3,5 folded before Flop (didn't bet)
Seat 9: Haek82 folded before Flop (didn't bet)
Seat 10: 1nyyfan folded before Flop (didn't bet)



PokerStars Game #6809053093:  Hold'em Limit ($0.50/$1.00) - 2006/10/28 - 22:47:31 (ET)
Table 'Tanina' 10-max Seat #5 is the button
Seat 1: JMAC60 ($32.85 in chips) 
Seat 3: wpcrso ($11.35 in chips) 
Seat 4: MrKGBoreoman ($18.70 in chips) 
Seat 5: call_me_pug ($31.65 in chips) 
Seat 6: OCbarrister ($16.70 in chips) 
Seat 7: Moooose ($18.25 in chips) 
Seat 8: 1,1,2,3,5 ($28.85 in chips) 
Seat 9: Haek82 ($19.10 in chips) 
Seat 10: 1nyyfan ($47.55 in chips) 
OCbarrister: posts small blind $0.25
Moooose: posts big blind $0.50
*** HOLE CARDS ***
Dealt to 1,1,2,3,5 [Jh 6c]
1,1,2,3,5: folds 
call_me_pug said, "n"
Haek82: folds 
1nyyfan: folds 
JMAC60: calls $0.50
wpcrso: folds 
MrKGBoreoman: folds 
call_me_pug: folds 
OCbarrister: calls $0.25
Moooose: checks 
*** FLOP *** [8c 8d 8h]
OCbarrister: checks 
Moooose: checks 
JMAC60: checks 
*** TURN *** [8c 8d 8h] [5c]
OCbarrister: checks 
Moooose: checks 
JMAC60: checks 
*** RIVER *** [8c 8d 8h 5c] [3c]
OCbarrister: checks 
Moooose: checks 
JMAC60: bets $1
OCbarrister: calls $1
Moooose: folds 
*** SHOW DOWN ***
JMAC60: shows [Tc 9c] (a flush, Ten high)
OCbarrister: mucks hand 
JMAC60 collected $3.35 from pot
*** SUMMARY ***
Total pot $3.50 | Rake $0.15 
Board [8c 8d 8h 5c 3c]
Seat 1: JMAC60 showed [Tc 9c] and won ($3.35) with a flush, Ten high
Seat 3: wpcrso folded before Flop (didn't bet)
Seat 4: MrKGBoreoman folded before Flop (didn't bet)
Seat 5: call_me_pug (button) folded before Flop (didn't bet)
Seat 6: OCbarrister (small blind) mucked [Ac Qd]
Seat 7: Moooose (big blind) folded on the River
Seat 8: 1,1,2,3,5 folded before Flop (didn't bet)
Seat 9: Haek82 folded before Flop (didn't bet)
Seat 10: 1nyyfan folded before Flop (didn't bet)



PokerStars Game #6809063711:  Hold'em Limit ($0.50/$1.00) - 2006/10/28 - 22:48:20 (ET)
Table 'Tanina' 10-max Seat #6 is the button
Seat 1: JMAC60 ($34.70 in chips) 
Seat 3: wpcrso ($11.35 in chips) 
Seat 4: MrKGBoreoman ($18.70 in chips) 
Seat 5: call_me_pug ($31.65 in chips) 
Seat 6: OCbarrister ($15.20 in chips) 
Seat 7: Moooose ($17.75 in chips) 
Seat 8: 1,1,2,3,5 ($28.85 in chips) 
Seat 9: Haek82 ($19.10 in chips) 
Seat 10: 1nyyfan ($47.55 in chips) 
Moooose: posts small blind $0.25
1,1,2,3,5: posts big blind $0.50
*** HOLE CARDS ***
Dealt to 1,1,2,3,5 [9d As]
Haek82: folds 
1nyyfan: folds 
JMAC60: folds 
wpcrso: folds 
Haek82 leaves the table
MrKGBoreoman: folds 
call_me_pug: calls $0.50
OCbarrister: folds 
Moooose: calls $0.25
1,1,2,3,5: checks 
*** FLOP *** [Ah 6h 8s]
Moooose: bets $0.50
1,1,2,3,5: calls $0.50
call_me_pug: raises $0.50 to $1
Moooose: raises $0.50 to $1.50
1,1,2,3,5: folds 
call_me_pug: calls $0.50
*** TURN *** [Ah 6h 8s] [2s]
Moooose: bets $1
call_me_pug: calls $1
*** RIVER *** [Ah 6h 8s 2s] [8h]
Moooose: bets $1
call_me_pug: calls $1
*** SHOW DOWN ***
Moooose: shows [8d 6d] (a full house, Eights full of Sixes)
call_me_pug: shows [Ad Qc] (two pair, Aces and Eights)
Moooose collected $8.60 from pot
*** SUMMARY ***
Total pot $9 | Rake $0.40 
Board [Ah 6h 8s 2s 8h]
Seat 1: JMAC60 folded before Flop (didn't bet)
Seat 3: wpcrso folded before Flop (didn't bet)
Seat 4: MrKGBoreoman folded before Flop (didn't bet)
Seat 5: call_me_pug showed [Ad Qc] and lost with two pair, Aces and Eights
Seat 6: OCbarrister (button) folded before Flop (didn't bet)
Seat 7: Moooose (small blind) showed [8d 6d] and won ($8.60) with a full house, Eights full of Sixes
Seat 8: 1,1,2,3,5 (big blind) folded on the Flop
Seat 9: Haek82 folded before Flop (didn't bet)
Seat 10: 1nyyfan folded before Flop (didn't bet)



PokerStars Game #6809075157:  Hold'em Limit ($0.50/$1.00) - 2006/10/28 - 22:49:13 (ET)
Table 'Tanina' 10-max Seat #7 is the button
Seat 1: JMAC60 ($34.70 in chips) 
Seat 3: wpcrso ($11.35 in chips) 
Seat 4: MrKGBoreoman ($18.70 in chips) 
Seat 5: call_me_pug ($27.65 in chips) 
Seat 6: OCbarrister ($15.20 in chips) 
Seat 7: Moooose ($22.35 in chips) 
Seat 8: 1,1,2,3,5 ($27.85 in chips) 
Seat 10: 1nyyfan ($47.55 in chips) 
1,1,2,3,5: posts small blind $0.25
1nyyfan: posts big blind $0.50
*** HOLE CARDS ***
Dealt to 1,1,2,3,5 [6c Js]
JMAC60: folds 
wpcrso: folds 
MrKGBoreoman: folds 
call_me_pug: calls $0.50
OCbarrister: folds 
Moooose: folds 
1,1,2,3,5: folds 
1nyyfan: checks 
*** FLOP *** [Kd 6d 9c]
1nyyfan: checks 
call_me_pug: checks 
*** TURN *** [Kd 6d 9c] [8s]
1nyyfan: checks 
call_me_pug: checks 
*** RIVER *** [Kd 6d 9c 8s] [3d]
1nyyfan: checks 
call_me_pug: checks 
*** SHOW DOWN ***
1nyyfan: shows [5s Ac] (high card Ace)
call_me_pug: shows [7s As] (high card Ace - King+Nine+Eight+Seven kicker)
call_me_pug collected $1.20 from pot
*** SUMMARY ***
Total pot $1.25 | Rake $0.05 
Board [Kd 6d 9c 8s 3d]
Seat 1: JMAC60 folded before Flop (didn't bet)
Seat 3: wpcrso folded before Flop (didn't bet)
Seat 4: MrKGBoreoman folded before Flop (didn't bet)
Seat 5: call_me_pug showed [7s As] and won ($1.20) with high card Ace
Seat 6: OCbarrister folded before Flop (didn't bet)
Seat 7: Moooose (button) folded before Flop (didn't bet)
Seat 8: 1,1,2,3,5 (small blind) folded before Flop
Seat 10: 1nyyfan (big blind) showed [5s Ac] and lost with high card Ace



PokerStars Game #6809081265:  Hold'em Limit ($0.50/$1.00) - 2006/10/28 - 22:49:40 (ET)
Table 'Tanina' 10-max Seat #8 is the button
Seat 1: JMAC60 ($34.70 in chips) 
Seat 3: wpcrso ($11.35 in chips) 
Seat 4: MrKGBoreoman ($18.70 in chips) 
Seat 5: call_me_pug ($28.35 in chips) 
Seat 6: OCbarrister ($15.20 in chips) 
Seat 7: Moooose ($22.35 in chips) 
Seat 8: 1,1,2,3,5 ($27.60 in chips) 
Seat 10: 1nyyfan ($47.05 in chips) 
1nyyfan: posts small blind $0.25
JMAC60: posts big blind $0.50
*** HOLE CARDS ***
Dealt to 1,1,2,3,5 [5s 9h]
wpcrso: folds 
MrKGBoreoman: folds 
call_me_pug: folds 
OCbarrister has timed out
OCbarrister: folds 
OCbarrister is sitting out
Moooose: folds 
1,1,2,3,5: folds 
1nyyfan: folds 
JMAC60 collected $0.50 from pot
JMAC60: doesn't show hand 
*** SUMMARY ***
Total pot $0.50 | Rake $0 
Seat 1: JMAC60 (big blind) collected ($0.50)
Seat 3: wpcrso folded before Flop (didn't bet)
Seat 4: MrKGBoreoman folded before Flop (didn't bet)
Seat 5: call_me_pug folded before Flop (didn't bet)
Seat 6: OCbarrister folded before Flop (didn't bet)
Seat 7: Moooose folded before Flop (didn't bet)
Seat 8: 1,1,2,3,5 (button) folded before Flop (didn't bet)
Seat 10: 1nyyfan (small blind) folded before Flop



PokerStars Game #6809088219:  Hold'em Limit ($0.50/$1.00) - 2006/10/28 - 22:50:12 (ET)
Table 'Tanina' 10-max Seat #10 is the button
Seat 1: JMAC60 ($34.95 in chips) 
Seat 3: wpcrso ($11.35 in chips) 
Seat 4: MrKGBoreoman ($18.70 in chips) 
Seat 5: call_me_pug ($28.35 in chips) 
Seat 7: Moooose ($22.35 in chips) 
Seat 8: 1,1,2,3,5 ($27.60 in chips) 
Seat 10: 1nyyfan ($46.80 in chips) 
JMAC60: posts small blind $0.25
wpcrso: posts big blind $0.50
*** HOLE CARDS ***
Dealt to 1,1,2,3,5 [5s Kd]
MrKGBoreoman: raises $0.50 to $1
call_me_pug: folds 
Moooose: folds 
OCbarrister has returned
1,1,2,3,5: folds 
1nyyfan: calls $1
JMAC60: folds 
wpcrso: folds 
*** FLOP *** [4h 3h 2s]
MrKGBoreoman: bets $0.50
1nyyfan: calls $0.50
*** TURN *** [4h 3h 2s] [Ah]
MrKGBoreoman: checks 
1nyyfan: checks 
*** RIVER *** [4h 3h 2s Ah] [9d]
MrKGBoreoman: bets $1
1nyyfan: calls $1
*** SHOW DOWN ***
MrKGBoreoman: shows [9h 9c] (three of a kind, Nines)
1nyyfan: mucks hand 
MrKGBoreoman collected $5.50 from pot
*** SUMMARY ***
Total pot $5.75 | Rake $0.25 
Board [4h 3h 2s Ah 9d]
Seat 1: JMAC60 (small blind) folded before Flop
Seat 3: wpcrso (big blind) folded before Flop
Seat 4: MrKGBoreoman showed [9h 9c] and won ($5.50) with three of a kind, Nines
Seat 5: call_me_pug folded before Flop (didn't bet)
Seat 7: Moooose folded before Flop (didn't bet)
Seat 8: 1,1,2,3,5 folded before Flop (didn't bet)
Seat 10: 1nyyfan (button) mucked [Ad 8d]



PokerStars Game #6809097640:  Hold'em Limit ($0.50/$1.00) - 2006/10/28 - 22:50:56 (ET)
Table 'Tanina' 10-max Seat #1 is the button
Seat 1: JMAC60 ($34.70 in chips) 
Seat 3: wpcrso ($10.85 in chips) 
Seat 4: MrKGBoreoman ($21.70 in chips) 
Seat 5: call_me_pug ($28.35 in chips) 
Seat 6: OCbarrister ($15.20 in chips) 
Seat 7: Moooose ($22.35 in chips) 
Seat 8: 1,1,2,3,5 ($27.60 in chips) 
Seat 10: 1nyyfan ($44.30 in chips) 
wpcrso: posts small blind $0.25
MrKGBoreoman: posts big blind $0.50
*** HOLE CARDS ***
Dealt to 1,1,2,3,5 [Qd Td]
call_me_pug: folds 
OCbarrister: folds 
Moooose: folds 
AOSD joins the table at seat #9 
1,1,2,3,5: calls $0.50
1nyyfan: folds 
JMAC60: raises $0.50 to $1
wpcrso: folds 
MrKGBoreoman: calls $0.50
1,1,2,3,5: calls $0.50
*** FLOP *** [6h Tc Ts]
MrKGBoreoman: checks 
1,1,2,3,5: bets $0.50
JMAC60: raises $0.50 to $1
MrKGBoreoman: folds 
1,1,2,3,5: raises $0.50 to $1.50
JMAC60: calls $0.50
*** TURN *** [6h Tc Ts] [6c]
1,1,2,3,5: bets $1
JMAC60: folds 
1,1,2,3,5 collected $5.95 from pot
1,1,2,3,5: doesn't show hand 
*** SUMMARY ***
Total pot $6.25 | Rake $0.30 
Board [6h Tc Ts 6c]
Seat 1: JMAC60 (button) folded on the Turn
Seat 3: wpcrso (small blind) folded before Flop
Seat 4: MrKGBoreoman (big blind) folded on the Flop
Seat 5: call_me_pug folded before Flop (didn't bet)
Seat 6: OCbarrister folded before Flop (didn't bet)
Seat 7: Moooose folded before Flop (didn't bet)
Seat 8: 1,1,2,3,5 collected ($5.95)
Seat 10: 1nyyfan folded before Flop (didn't bet)



PokerStars Game #6809108482:  Hold'em Limit ($0.50/$1.00) - 2006/10/28 - 22:51:46 (ET)
Table 'Tanina' 10-max Seat #3 is the button
Seat 1: JMAC60 ($32.20 in chips) 
Seat 3: wpcrso ($10.60 in chips) 
Seat 4: MrKGBoreoman ($20.70 in chips) 
Seat 5: call_me_pug ($28.35 in chips) 
Seat 6: OCbarrister ($15.20 in chips) 
Seat 7: Moooose ($22.35 in chips) 
Seat 8: 1,1,2,3,5 ($31.05 in chips) 
Seat 10: 1nyyfan ($44.30 in chips) 
MrKGBoreoman: posts small blind $0.25
call_me_pug: posts big blind $0.50
AOSD: sits out 
*** HOLE CARDS ***
Dealt to 1,1,2,3,5 [Ad Jh]
OCbarrister: folds 
Moooose: folds 
1,1,2,3,5: raises $0.50 to $1
1nyyfan: folds 
JMAC60: raises $0.50 to $1.50
wpcrso: folds 
MrKGBoreoman: folds 
call_me_pug: folds 
1,1,2,3,5: calls $0.50
*** FLOP *** [9s 6c Tc]
1,1,2,3,5: checks 
JMAC60: bets $0.50
1,1,2,3,5: folds 
JMAC60 collected $3.60 from pot
JMAC60: doesn't show hand 
*** SUMMARY ***
Total pot $3.75 | Rake $0.15 
Board [9s 6c Tc]
Seat 1: JMAC60 collected ($3.60)
Seat 3: wpcrso (button) folded before Flop (didn't bet)
Seat 4: MrKGBoreoman (small blind) folded before Flop
Seat 5: call_me_pug (big blind) folded before Flop
Seat 6: OCbarrister folded before Flop (didn't bet)
Seat 7: Moooose folded before Flop (didn't bet)
Seat 8: 1,1,2,3,5 folded on the Flop
Seat 10: 1nyyfan folded before Flop (didn't bet)



PokerStars Game #6809116231:  Hold'em Limit ($0.50/$1.00) - 2006/10/28 - 22:52:22 (ET)
Table 'Tanina' 10-max Seat #4 is the button
Seat 1: JMAC60 ($34.30 in chips) 
Seat 3: wpcrso ($10.60 in chips) 
Seat 4: MrKGBoreoman ($20.45 in chips) 
Seat 5: call_me_pug ($27.85 in chips) 
Seat 6: OCbarrister ($15.20 in chips) 
Seat 7: Moooose ($22.35 in chips) 
Seat 8: 1,1,2,3,5 ($29.55 in chips) 
Seat 10: 1nyyfan ($44.30 in chips) 
call_me_pug: posts small blind $0.25
OCbarrister: posts big blind $0.50
AOSD: sits out 
*** HOLE CARDS ***
Dealt to 1,1,2,3,5 [8s 9h]
Moooose: folds 
1,1,2,3,5: folds 
1nyyfan: folds 
JMAC60: folds 
wpcrso: folds 
MrKGBoreoman: folds 
call_me_pug: folds 
OCbarrister collected $0.50 from pot
*** SUMMARY ***
Total pot $0.50 | Rake $0 
Seat 1: JMAC60 folded before Flop (didn't bet)
Seat 3: wpcrso folded before Flop (didn't bet)
Seat 4: MrKGBoreoman (button) folded before Flop (didn't bet)
Seat 5: call_me_pug (small blind) folded before Flop
Seat 6: OCbarrister (big blind) collected ($0.50)
Seat 7: Moooose folded before Flop (didn't bet)
Seat 8: 1,1,2,3,5 folded before Flop (didn't bet)
Seat 10: 1nyyfan folded before Flop (didn't bet)



PokerStars Game #6809121024:  Hold'em Limit ($0.50/$1.00) - 2006/10/28 - 22:52:45 (ET)
Table 'Tanina' 10-max Seat #5 is the button
Seat 1: JMAC60 ($34.30 in chips) 
Seat 3: wpcrso ($10.60 in chips) 
Seat 4: MrKGBoreoman ($20.45 in chips) 
Seat 5: call_me_pug ($27.60 in chips) 
Seat 6: OCbarrister ($15.45 in chips) 
Seat 7: Moooose ($22.35 in chips) 
Seat 8: 1,1,2,3,5 ($29.55 in chips) 
Seat 10: 1nyyfan ($44.30 in chips) 
OCbarrister: posts small blind $0.25
Moooose: posts big blind $0.50
AOSD: sits out 
*** HOLE CARDS ***
Dealt to 1,1,2,3,5 [8h Jc]
1,1,2,3,5: folds 
1nyyfan: folds 
JMAC60: folds 
wpcrso: folds 
MrKGBoreoman: folds 
call_me_pug: folds 
OCbarrister: calls $0.25
Moooose: checks 
*** FLOP *** [Qd 9d 9s]
OCbarrister: checks 
Moooose: checks 
*** TURN *** [Qd 9d 9s] [8s]
OCbarrister: checks 
Moooose: bets $1
OCbarrister: calls $1
*** RIVER *** [Qd 9d 9s 8s] [Ad]
OCbarrister: bets $1
Moooose: folds 
OCbarrister collected $2.90 from pot
*** SUMMARY ***
Total pot $3 | Rake $0.10 
Board [Qd 9d 9s 8s Ad]
Seat 1: JMAC60 folded before Flop (didn't bet)
Seat 3: wpcrso folded before Flop (didn't bet)
Seat 4: MrKGBoreoman folded before Flop (didn't bet)
Seat 5: call_me_pug (button) folded before Flop (didn't bet)
Seat 6: OCbarrister (small blind) collected ($2.90)
Seat 7: Moooose (big blind) folded on the River
Seat 8: 1,1,2,3,5 folded before Flop (didn't bet)
Seat 10: 1nyyfan folded before Flop (didn't bet)



PokerStars Game #6809128963:  Hold'em Limit ($0.50/$1.00) - 2006/10/28 - 22:53:22 (ET)
Table 'Tanina' 10-max Seat #6 is the button
Seat 1: JMAC60 ($34.30 in chips) 
Seat 3: wpcrso ($10.60 in chips) 
Seat 4: MrKGBoreoman ($20.45 in chips) 
Seat 5: call_me_pug ($27.60 in chips) 
Seat 6: OCbarrister ($16.85 in chips) 
Seat 7: Moooose ($20.85 in chips) 
Seat 8: 1,1,2,3,5 ($29.55 in chips) 
Seat 10: 1nyyfan ($44.30 in chips) 
Moooose: posts small blind $0.25
1,1,2,3,5: posts big blind $0.50
AOSD: sits out 
*** HOLE CARDS ***
Dealt to 1,1,2,3,5 [2s Tc]
1nyyfan: folds 
JMAC60: folds 
wpcrso: folds 
MrKGBoreoman: raises $0.50 to $1
call_me_pug: calls $1
OCbarrister: folds 
Moooose: calls $0.75
1,1,2,3,5: folds 
*** FLOP *** [Kc 3h 3c]
Moooose: checks 
MrKGBoreoman: bets $0.50
call_me_pug: calls $0.50
Moooose: folds 
*** TURN *** [Kc 3h 3c] [2h]
MrKGBoreoman: checks 
call_me_pug: bets $1
MrKGBoreoman: calls $1
*** RIVER *** [Kc 3h 3c 2h] [8c]
MrKGBoreoman: checks 
call_me_pug: checks 
*** SHOW DOWN ***
MrKGBoreoman: shows [Qh Qd] (two pair, Queens and Threes)
call_me_pug: mucks hand 
MrKGBoreoman collected $6.20 from pot
*** SUMMARY ***
Total pot $6.50 | Rake $0.30 
Board [Kc 3h 3c 2h 8c]
Seat 1: JMAC60 folded before Flop (didn't bet)
Seat 3: wpcrso folded before Flop (didn't bet)
Seat 4: MrKGBoreoman showed [Qh Qd] and won ($6.20) with two pair, Queens and Threes
Seat 5: call_me_pug mucked [Ah Qs]
Seat 6: OCbarrister (button) folded before Flop (didn't bet)
Seat 7: Moooose (small blind) folded on the Flop
Seat 8: 1,1,2,3,5 (big blind) folded before Flop
Seat 10: 1nyyfan folded before Flop (didn't bet)



PokerStars Game #6809141095:  Hold'em Limit ($0.50/$1.00) - 2006/10/28 - 22:54:18 (ET)
Table 'Tanina' 10-max Seat #7 is the button
Seat 1: JMAC60 ($34.30 in chips) 
Seat 3: wpcrso ($10.60 in chips) 
Seat 4: MrKGBoreoman ($24.15 in chips) 
Seat 5: call_me_pug ($25.10 in chips) 
Seat 6: OCbarrister ($16.85 in chips) 
Seat 7: Moooose ($19.85 in chips) 
Seat 8: 1,1,2,3,5 ($29.05 in chips) 
Seat 9: AOSD ($20 in chips) 
Seat 10: 1nyyfan ($44.30 in chips) 
1,1,2,3,5: posts small blind $0.25
AOSD: posts big blind $0.50
*** HOLE CARDS ***
Dealt to 1,1,2,3,5 [Ts 5s]
1nyyfan: raises $0.50 to $1
JMAC60: folds 
wpcrso: folds 
MrKGBoreoman: folds 
call_me_pug: folds 
OCbarrister: folds 
Moooose: folds 
1,1,2,3,5: folds 
AOSD: folds 
1nyyfan collected $1.25 from pot
*** SUMMARY ***
Total pot $1.25 | Rake $0 
Seat 1: JMAC60 folded before Flop (didn't bet)
Seat 3: wpcrso folded before Flop (didn't bet)
Seat 4: MrKGBoreoman folded before Flop (didn't bet)
Seat 5: call_me_pug folded before Flop (didn't bet)
Seat 6: OCbarrister folded before Flop (didn't bet)
Seat 7: Moooose (button) folded before Flop (didn't bet)
Seat 8: 1,1,2,3,5 (small blind) folded before Flop
Seat 9: AOSD (big blind) folded before Flop
Seat 10: 1nyyfan collected ($1.25)



PokerStars Game #6809145299:  Hold'em Limit ($0.50/$1.00) - 2006/10/28 - 22:54:35 (ET)
Table 'Tanina' 10-max Seat #8 is the button
Seat 1: JMAC60 ($34.30 in chips) 
Seat 3: wpcrso ($10.60 in chips) 
Seat 4: MrKGBoreoman ($24.15 in chips) 
Seat 5: call_me_pug ($25.10 in chips) 
Seat 6: OCbarrister ($16.85 in chips) 
Seat 7: Moooose ($19.85 in chips) 
Seat 8: 1,1,2,3,5 ($28.80 in chips) 
Seat 9: AOSD ($19.50 in chips) 
Seat 10: 1nyyfan ($45.05 in chips) 
AOSD: posts small blind $0.25
1nyyfan: posts big blind $0.50
*** HOLE CARDS ***
Dealt to 1,1,2,3,5 [Qh 3s]
JMAC60: folds 
wpcrso: folds 
MrKGBoreoman: folds 
call_me_pug: folds 
OCbarrister: calls $0.50
Moooose: folds 
1,1,2,3,5: folds 
AOSD: folds 
1nyyfan: checks 
*** FLOP *** [4c 5h Kh]
1nyyfan: checks 
OCbarrister: bets $0.50
1nyyfan: calls $0.50
*** TURN *** [4c 5h Kh] [Tc]
1nyyfan: checks 
OCbarrister: bets $1
1nyyfan: calls $1
*** RIVER *** [4c 5h Kh Tc] [4d]
1nyyfan: checks 
OCbarrister: bets $1
1nyyfan: calls $1
*** SHOW DOWN ***
OCbarrister: shows [Ks 8c] (two pair, Kings and Fours)
1nyyfan: mucks hand 
OCbarrister collected $5.95 from pot
*** SUMMARY ***
Total pot $6.25 | Rake $0.30 
Board [4c 5h Kh Tc 4d]
Seat 1: JMAC60 folded before Flop (didn't bet)
Seat 3: wpcrso folded before Flop (didn't bet)
Seat 4: MrKGBoreoman folded before Flop (didn't bet)
Seat 5: call_me_pug folded before Flop (didn't bet)
Seat 6: OCbarrister showed [Ks 8c] and won ($5.95) with two pair, Kings and Fours
Seat 7: Moooose folded before Flop (didn't bet)
Seat 8: 1,1,2,3,5 (button) folded before Flop (didn't bet)
Seat 9: AOSD (small blind) folded before Flop
Seat 10: 1nyyfan (big blind) mucked [Js Jc]



PokerStars Game #6809152574:  Hold'em Limit ($0.50/$1.00) - 2006/10/28 - 22:55:09 (ET)
Table 'Tanina' 10-max Seat #9 is the button
Seat 1: JMAC60 ($34.30 in chips) 
Seat 3: wpcrso ($10.60 in chips) 
Seat 4: MrKGBoreoman ($24.15 in chips) 
Seat 5: call_me_pug ($25.10 in chips) 
Seat 6: OCbarrister ($19.80 in chips) 
Seat 7: Moooose ($19.85 in chips) 
Seat 8: 1,1,2,3,5 ($28.80 in chips) 
Seat 9: AOSD ($19.25 in chips) 
Seat 10: 1nyyfan ($42.05 in chips) 
1nyyfan: posts small blind $0.25
JMAC60: posts big blind $0.50
*** HOLE CARDS ***
Dealt to 1,1,2,3,5 [7d 3c]
wpcrso: folds 
MrKGBoreoman: folds 
call_me_pug: folds 
OCbarrister: folds 
Moooose: folds 
1,1,2,3,5: folds 
AOSD: folds 
1nyyfan: calls $0.25
JMAC60: checks 
*** FLOP *** [7c 4d Ah]
1nyyfan: checks 
JMAC60: checks 
*** TURN *** [7c 4d Ah] [5c]
1nyyfan: checks 
JMAC60: bets $1
1nyyfan: folds 
JMAC60 collected $0.95 from pot
JMAC60: doesn't show hand 
*** SUMMARY ***
Total pot $1 | Rake $0.05 
Board [7c 4d Ah 5c]
Seat 1: JMAC60 (big blind) collected ($0.95)
Seat 3: wpcrso folded before Flop (didn't bet)
Seat 4: MrKGBoreoman folded before Flop (didn't bet)
Seat 5: call_me_pug folded before Flop (didn't bet)
Seat 6: OCbarrister folded before Flop (didn't bet)
Seat 7: Moooose folded before Flop (didn't bet)
Seat 8: 1,1,2,3,5 folded before Flop (didn't bet)
Seat 9: AOSD (button) folded before Flop (didn't bet)
Seat 10: 1nyyfan (small blind) folded on the Turn



PokerStars Game #6809158758:  Hold'em Limit ($0.50/$1.00) - 2006/10/28 - 22:55:37 (ET)
Table 'Tanina' 10-max Seat #10 is the button
Seat 1: JMAC60 ($34.75 in chips) 
Seat 3: wpcrso ($10.60 in chips) 
Seat 4: MrKGBoreoman ($24.15 in chips) 
Seat 5: call_me_pug ($25.10 in chips) 
Seat 6: OCbarrister ($19.80 in chips) 
Seat 7: Moooose ($19.85 in chips) 
Seat 8: 1,1,2,3,5 ($28.80 in chips) 
Seat 9: AOSD ($19.25 in chips) 
Seat 10: 1nyyfan ($41.55 in chips) 
JMAC60: posts small blind $0.25
wpcrso: posts big blind $0.50
*** HOLE CARDS ***
Dealt to 1,1,2,3,5 [Ah Kd]
MrKGBoreoman: folds 
call_me_pug: folds 
OCbarrister: folds 
Moooose: folds 
1,1,2,3,5: raises $0.50 to $1
AOSD: folds 
1nyyfan: folds 
JMAC60: folds 
wpcrso: folds 
1,1,2,3,5 collected $1.25 from pot
1,1,2,3,5: doesn't show hand 
*** SUMMARY ***
Total pot $1.25 | Rake $0 
Seat 1: JMAC60 (small blind) folded before Flop
Seat 3: wpcrso (big blind) folded before Flop
Seat 4: MrKGBoreoman folded before Flop (didn't bet)
Seat 5: call_me_pug folded before Flop (didn't bet)
Seat 6: OCbarrister folded before Flop (didn't bet)
Seat 7: Moooose folded before Flop (didn't bet)
Seat 8: 1,1,2,3,5 collected ($1.25)
Seat 9: AOSD folded before Flop (didn't bet)
Seat 10: 1nyyfan (button) folded before Flop (didn't bet)



PokerStars Game #6809162617:  Hold'em Limit ($0.50/$1.00) - 2006/10/28 - 22:55:55 (ET)
Table 'Tanina' 10-max Seat #1 is the button
Seat 1: JMAC60 ($34.50 in chips) 
Seat 3: wpcrso ($10.10 in chips) 
Seat 4: MrKGBoreoman ($24.15 in chips) 
Seat 5: call_me_pug ($25.10 in chips) 
Seat 6: OCbarrister ($19.80 in chips) 
Seat 7: Moooose ($19.85 in chips) 
Seat 8: 1,1,2,3,5 ($29.55 in chips) 
Seat 9: AOSD ($19.25 in chips) 
Seat 10: 1nyyfan ($41.55 in chips) 
wpcrso: posts small blind $0.25
MrKGBoreoman: posts big blind $0.50
*** HOLE CARDS ***
Dealt to 1,1,2,3,5 [4c 7d]
call_me_pug: folds 
OCbarrister: folds 
Moooose: folds 
1,1,2,3,5: folds 
AOSD: folds 
1nyyfan: calls $0.50
JMAC60: folds 
wpcrso: folds 
MrKGBoreoman: checks 
*** FLOP *** [8c 2c As]
MrKGBoreoman: checks 
1nyyfan: bets $0.50
MrKGBoreoman: folds 
1nyyfan collected $1.20 from pot
*** SUMMARY ***
Total pot $1.25 | Rake $0.05 
Board [8c 2c As]
Seat 1: JMAC60 (button) folded before Flop (didn't bet)
Seat 3: wpcrso (small blind) folded before Flop
Seat 4: MrKGBoreoman (big blind) folded on the Flop
Seat 5: call_me_pug folded before Flop (didn't bet)
Seat 6: OCbarrister folded before Flop (didn't bet)
Seat 7: Moooose folded before Flop (didn't bet)
Seat 8: 1,1,2,3,5 folded before Flop (didn't bet)
Seat 9: AOSD folded before Flop (didn't bet)
Seat 10: 1nyyfan collected ($1.20)



PokerStars Game #6809169244:  Hold'em Limit ($0.50/$1.00) - 2006/10/28 - 22:56:25 (ET)
Table 'Tanina' 10-max Seat #3 is the button
Seat 1: JMAC60 ($34.50 in chips) 
Seat 3: wpcrso ($9.85 in chips) 
Seat 4: MrKGBoreoman ($23.65 in chips) 
Seat 5: call_me_pug ($25.10 in chips) 
Seat 6: OCbarrister ($19.80 in chips) 
Seat 7: Moooose ($19.85 in chips) 
Seat 8: 1,1,2,3,5 ($29.55 in chips) 
Seat 9: AOSD ($19.25 in chips) 
Seat 10: 1nyyfan ($42.25 in chips) 
MrKGBoreoman: posts small blind $0.25
call_me_pug: posts big blind $0.50
*** HOLE CARDS ***
Dealt to 1,1,2,3,5 [Ts Kd]
OCbarrister: folds 
Moooose: folds 
1,1,2,3,5: folds 
AOSD: folds 
1nyyfan: folds 
JMAC60: folds 
wpcrso: folds 
MrKGBoreoman: folds 
call_me_pug collected $0.50 from pot
*** SUMMARY ***
Total pot $0.50 | Rake $0 
Seat 1: JMAC60 folded before Flop (didn't bet)
Seat 3: wpcrso (button) folded before Flop (didn't bet)
Seat 4: MrKGBoreoman (small blind) folded before Flop
Seat 5: call_me_pug (big blind) collected ($0.50)
Seat 6: OCbarrister folded before Flop (didn't bet)
Seat 7: Moooose folded before Flop (didn't bet)
Seat 8: 1,1,2,3,5 folded before Flop (didn't bet)
Seat 9: AOSD folded before Flop (didn't bet)
Seat 10: 1nyyfan folded before Flop (didn't bet)



PokerStars Game #6809176547:  Hold'em Limit ($0.50/$1.00) - 2006/10/28 - 22:56:58 (ET)
Table 'Tanina' 10-max Seat #4 is the button
Seat 1: JMAC60 ($34.50 in chips) 
Seat 3: wpcrso ($9.85 in chips) 
Seat 4: MrKGBoreoman ($23.40 in chips) 
Seat 5: call_me_pug ($25.35 in chips) 
Seat 6: OCbarrister ($19.80 in chips) 
Seat 7: Moooose ($19.85 in chips) 
Seat 8: 1,1,2,3,5 ($29.55 in chips) 
Seat 9: AOSD ($19.25 in chips) 
Seat 10: 1nyyfan ($42.25 in chips) 
call_me_pug: posts small blind $0.25
OCbarrister: posts big blind $0.50
*** HOLE CARDS ***
Dealt to 1,1,2,3,5 [5h 3h]
Moooose: folds 
1,1,2,3,5: folds 
AOSD: folds 
1nyyfan: folds 
JMAC60: calls $0.50
wpcrso: folds 
MrKGBoreoman: folds 
call_me_pug: calls $0.25
OCbarrister: checks 
*** FLOP *** [9s Ks Jh]
call_me_pug: checks 
OCbarrister: checks 
JMAC60: bets $0.50
call_me_pug: calls $0.50
OCbarrister: calls $0.50
*** TURN *** [9s Ks Jh] [7c]
call_me_pug: checks 
OCbarrister: checks 
JMAC60: bets $1
call_me_pug: folds 
OCbarrister: calls $1
*** RIVER *** [9s Ks Jh 7c] [6h]
OCbarrister: checks 
JMAC60: bets $1
OCbarrister: folds 
JMAC60 collected $4.80 from pot
JMAC60: doesn't show hand 
*** SUMMARY ***
Total pot $5 | Rake $0.20 
Board [9s Ks Jh 7c 6h]
Seat 1: JMAC60 collected ($4.80)
Seat 3: wpcrso folded before Flop (didn't bet)
Seat 4: MrKGBoreoman (button) folded before Flop (didn't bet)
Seat 5: call_me_pug (small blind) folded on the Turn
Seat 6: OCbarrister (big blind) folded on the River
Seat 7: Moooose folded before Flop (didn't bet)
Seat 8: 1,1,2,3,5 folded before Flop (didn't bet)
Seat 9: AOSD folded before Flop (didn't bet)
Seat 10: 1nyyfan folded before Flop (didn't bet)



PokerStars Game #6809191076:  Hold'em Limit ($0.50/$1.00) - 2006/10/28 - 22:58:03 (ET)
Table 'Tanina' 10-max Seat #5 is the button
Seat 1: JMAC60 ($37.30 in chips) 
Seat 3: wpcrso ($9.85 in chips) 
Seat 4: MrKGBoreoman ($23.40 in chips) 
Seat 5: call_me_pug ($24.35 in chips) 
Seat 6: OCbarrister ($17.80 in chips) 
Seat 7: Moooose ($19.85 in chips) 
Seat 8: 1,1,2,3,5 ($29.55 in chips) 
Seat 9: AOSD ($19.25 in chips) 
Seat 10: 1nyyfan ($42.25 in chips) 
OCbarrister: posts small blind $0.25
Moooose: posts big blind $0.50
*** HOLE CARDS ***
Dealt to 1,1,2,3,5 [9s 7s]
1,1,2,3,5: folds 
AOSD: folds 
1nyyfan: folds 
JMAC60: raises $0.50 to $1
wpcrso: folds 
MrKGBoreoman: folds 
call_me_pug: calls $1
OCbarrister: folds 
Moooose: raises $0.50 to $1.50
JMAC60: calls $0.50
call_me_pug: calls $0.50
*** FLOP *** [Qh 2d 3d]
Moooose: bets $0.50
JMAC60: raises $0.50 to $1
call_me_pug: calls $1
Moooose: raises $0.50 to $1.50
JMAC60: folds 
call_me_pug: calls $0.50
*** TURN *** [Qh 2d 3d] [9c]
Moooose: bets $1
call_me_pug: folds 
Moooose collected $8.35 from pot
Moooose: doesn't show hand 
*** SUMMARY ***
Total pot $8.75 | Rake $0.40 
Board [Qh 2d 3d 9c]
Seat 1: JMAC60 folded on the Flop
Seat 3: wpcrso folded before Flop (didn't bet)
Seat 4: MrKGBoreoman folded before Flop (didn't bet)
Seat 5: call_me_pug (button) folded on the Turn
Seat 6: OCbarrister (small blind) folded before Flop
Seat 7: Moooose (big blind) collected ($8.35)
Seat 8: 1,1,2,3,5 folded before Flop (didn't bet)
Seat 9: AOSD folded before Flop (didn't bet)
Seat 10: 1nyyfan folded before Flop (didn't bet)



PokerStars Game #6809206287:  Hold'em Limit ($0.50/$1.00) - 2006/10/28 - 22:59:13 (ET)
Table 'Tanina' 10-max Seat #6 is the button
Seat 1: JMAC60 ($34.80 in chips) 
Seat 3: wpcrso ($9.85 in chips) 
Seat 4: MrKGBoreoman ($23.40 in chips) 
Seat 5: call_me_pug ($21.35 in chips) 
Seat 6: OCbarrister ($17.55 in chips) 
Seat 7: Moooose ($25.20 in chips) 
Seat 8: 1,1,2,3,5 ($29.55 in chips) 
Seat 9: AOSD ($19.25 in chips) 
Seat 10: 1nyyfan ($42.25 in chips) 
Moooose: posts small blind $0.25
1,1,2,3,5: posts big blind $0.50
*** HOLE CARDS ***
Dealt to 1,1,2,3,5 [7d 6s]
AOSD: calls $0.50
1nyyfan: folds 
JMAC60: folds 
wpcrso: folds 
MrKGBoreoman: folds 
call_me_pug: folds 
OCbarrister: folds 
Moooose: calls $0.25
1,1,2,3,5: checks 
*** FLOP *** [Kc 9d 2h]
Moooose: checks 
1,1,2,3,5: checks 
AOSD: checks 
*** TURN *** [Kc 9d 2h] [Js]
Moooose: bets $1
1,1,2,3,5: folds 
AOSD: folds 
Moooose collected $1.45 from pot
Moooose: doesn't show hand 
*** SUMMARY ***
Total pot $1.50 | Rake $0.05 
Board [Kc 9d 2h Js]
Seat 1: JMAC60 folded before Flop (didn't bet)
Seat 3: wpcrso folded before Flop (didn't bet)
Seat 4: MrKGBoreoman folded before Flop (didn't bet)
Seat 5: call_me_pug folded before Flop (didn't bet)
Seat 6: OCbarrister (button) folded before Flop (didn't bet)
Seat 7: Moooose (small blind) collected ($1.45)
Seat 8: 1,1,2,3,5 (big blind) folded on the Turn
Seat 9: AOSD folded on the Turn
Seat 10: 1nyyfan folded before Flop (didn't bet)



PokerStars Game #6809217776:  Hold'em Limit ($0.50/$1.00) - 2006/10/28 - 23:00:02 (ET)
Table 'Tanina' 10-max Seat #7 is the button
Seat 1: JMAC60 ($34.80 in chips) 
Seat 3: wpcrso ($9.85 in chips) 
Seat 4: MrKGBoreoman ($23.40 in chips) 
Seat 5: call_me_pug ($21.35 in chips) 
Seat 6: OCbarrister ($17.55 in chips) 
Seat 7: Moooose ($26.15 in chips) 
Seat 8: 1,1,2,3,5 ($29.05 in chips) 
Seat 9: AOSD ($18.75 in chips) 
Seat 10: 1nyyfan ($42.25 in chips) 
1,1,2,3,5: posts small blind $0.25
AOSD: posts big blind $0.50
*** HOLE CARDS ***
Dealt to 1,1,2,3,5 [Tc Qh]
1nyyfan: folds 
JMAC60: folds 
wpcrso: folds 
MrKGBoreoman: folds 
call_me_pug: folds 
OCbarrister: calls $0.50
Moooose: folds 
1,1,2,3,5: calls $0.25
AOSD: checks 
*** FLOP *** [9s Ks Ah]
1,1,2,3,5: checks 
AOSD: checks 
OCbarrister: bets $0.50
1,1,2,3,5: folds 
AOSD: folds 
OCbarrister collected $1.45 from pot
OCbarrister: doesn't show hand 
*** SUMMARY ***
Total pot $1.50 | Rake $0.05 
Board [9s Ks Ah]
Seat 1: JMAC60 folded before Flop (didn't bet)
Seat 3: wpcrso folded before Flop (didn't bet)
Seat 4: MrKGBoreoman folded before Flop (didn't bet)
Seat 5: call_me_pug folded before Flop (didn't bet)
Seat 6: OCbarrister collected ($1.45)
Seat 7: Moooose (button) folded before Flop (didn't bet)
Seat 8: 1,1,2,3,5 (small blind) folded on the Flop
Seat 9: AOSD (big blind) folded on the Flop
Seat 10: 1nyyfan folded before Flop (didn't bet)



PokerStars Game #6809229021:  Hold'em Limit ($0.50/$1.00) - 2006/10/28 - 23:00:54 (ET)
Table 'Tanina' 10-max Seat #8 is the button
Seat 1: JMAC60 ($34.80 in chips) 
Seat 3: wpcrso ($9.85 in chips) 
Seat 4: MrKGBoreoman ($23.40 in chips) 
Seat 5: call_me_pug ($21.35 in chips) 
Seat 6: OCbarrister ($18.50 in chips) 
Seat 7: Moooose ($26.15 in chips) 
Seat 8: 1,1,2,3,5 ($28.55 in chips) 
Seat 9: AOSD ($18.25 in chips) 
Seat 10: 1nyyfan ($42.25 in chips) 
AOSD: posts small blind $0.25
1nyyfan: posts big blind $0.50
*** HOLE CARDS ***
Dealt to 1,1,2,3,5 [9s Ts]
JMAC60: folds 
wpcrso: calls $0.50
MrKGBoreoman: folds 
call_me_pug: folds 
OCbarrister: folds 
Moooose: calls $0.50
1,1,2,3,5: folds 
AOSD: folds 
1nyyfan: checks 
*** FLOP *** [Jc 4d Ks]
1nyyfan: checks 
wpcrso: checks 
Moooose: bets $0.50
1nyyfan: folds 
wpcrso: folds 
Moooose collected $1.70 from pot
Moooose: doesn't show hand 
*** SUMMARY ***
Total pot $1.75 | Rake $0.05 
Board [Jc 4d Ks]
Seat 1: JMAC60 folded before Flop (didn't bet)
Seat 3: wpcrso folded on the Flop
Seat 4: MrKGBoreoman folded before Flop (didn't bet)
Seat 5: call_me_pug folded before Flop (didn't bet)
Seat 6: OCbarrister folded before Flop (didn't bet)
Seat 7: Moooose collected ($1.70)
Seat 8: 1,1,2,3,5 (button) folded before Flop (didn't bet)
Seat 9: AOSD (small blind) folded before Flop
Seat 10: 1nyyfan (big blind) folded on the Flop



PokerStars Game #6809237777:  Hold'em Limit ($0.50/$1.00) - 2006/10/28 - 23:01:33 (ET)
Table 'Tanina' 10-max Seat #9 is the button
Seat 1: JMAC60 ($34.80 in chips) 
Seat 3: wpcrso ($9.35 in chips) 
Seat 4: MrKGBoreoman ($23.40 in chips) 
Seat 5: call_me_pug ($21.35 in chips) 
Seat 6: OCbarrister ($18.50 in chips) 
Seat 7: Moooose ($27.35 in chips) 
Seat 8: 1,1,2,3,5 ($28.55 in chips) 
Seat 9: AOSD ($18 in chips) 
Seat 10: 1nyyfan ($41.75 in chips) 
1nyyfan: posts small blind $0.25
JMAC60: posts big blind $0.50
*** HOLE CARDS ***
Dealt to 1,1,2,3,5 [4d 6h]
wpcrso: folds 
MrKGBoreoman: folds 
call_me_pug: folds 
OCbarrister: calls $0.50
Moooose: folds 
1,1,2,3,5: folds 
AOSD: calls $0.50
1nyyfan: folds 
JMAC60: checks 
*** FLOP *** [3c Tc 8h]
JMAC60: checks 
OCbarrister: checks 
AOSD: checks 
*** TURN *** [3c Tc 8h] [6d]
JMAC60: bets $1
OCbarrister: calls $1
AOSD: folds 
*** RIVER *** [3c Tc 8h 6d] [Ks]
JMAC60: bets $1
OCbarrister: calls $1
*** SHOW DOWN ***
JMAC60: shows [Kd 8s] (two pair, Kings and Eights)
OCbarrister: mucks hand 
JMAC60 collected $5.50 from pot
*** SUMMARY ***
Total pot $5.75 | Rake $0.25 
Board [3c Tc 8h 6d Ks]
Seat 1: JMAC60 (big blind) showed [Kd 8s] and won ($5.50) with two pair, Kings and Eights
Seat 3: wpcrso folded before Flop (didn't bet)
Seat 4: MrKGBoreoman folded before Flop (didn't bet)
Seat 5: call_me_pug folded before Flop (didn't bet)
Seat 6: OCbarrister mucked [Jh Ts]
Seat 7: Moooose folded before Flop (didn't bet)
Seat 8: 1,1,2,3,5 folded before Flop (didn't bet)
Seat 9: AOSD (button) folded on the Turn
Seat 10: 1nyyfan (small blind) folded before Flop



PokerStars Game #6809249189:  Hold'em Limit ($0.50/$1.00) - 2006/10/28 - 23:02:23 (ET)
Table 'Tanina' 10-max Seat #10 is the button
Seat 1: JMAC60 ($37.80 in chips) 
Seat 3: wpcrso ($9.35 in chips) 
Seat 4: MrKGBoreoman ($23.40 in chips) 
Seat 5: call_me_pug ($21.35 in chips) 
Seat 6: OCbarrister ($16 in chips) 
Seat 7: Moooose ($27.35 in chips) 
Seat 8: 1,1,2,3,5 ($28.55 in chips) 
Seat 9: AOSD ($17.50 in chips) 
Seat 10: 1nyyfan ($41.50 in chips) 
JMAC60: posts small blind $0.25
wpcrso: posts big blind $0.50
*** HOLE CARDS ***
Dealt to 1,1,2,3,5 [3h 8c]
MrKGBoreoman: folds 
call_me_pug: folds 
OCbarrister: calls $0.50
Moooose: calls $0.50
1,1,2,3,5: folds 
AOSD: folds 
1nyyfan: folds 
JMAC60: folds 
wpcrso: checks 
*** FLOP *** [9d Ac Js]
wpcrso: checks 
OCbarrister: checks 
Moooose: checks 
*** TURN *** [9d Ac Js] [Qd]
wpcrso: checks 
OCbarrister: checks 
Moooose: bets $1
wpcrso: folds 
OCbarrister: calls $1
*** RIVER *** [9d Ac Js Qd] [Jd]
OCbarrister: checks 
Moooose: bets $1
OCbarrister: folds 
Moooose collected $3.60 from pot
Moooose: shows [Kc Th] (a straight, Ten to Ace)
*** SUMMARY ***
Total pot $3.75 | Rake $0.15 
Board [9d Ac Js Qd Jd]
Seat 1: JMAC60 (small blind) folded before Flop
Seat 3: wpcrso (big blind) folded on the Turn
Seat 4: MrKGBoreoman folded before Flop (didn't bet)
Seat 5: call_me_pug folded before Flop (didn't bet)
Seat 6: OCbarrister folded on the River
Seat 7: Moooose collected ($3.60)
Seat 8: 1,1,2,3,5 folded before Flop (didn't bet)
Seat 9: AOSD folded before Flop (didn't bet)
Seat 10: 1nyyfan (button) folded before Flop (didn't bet)



PokerStars Game #6809261548:  Hold'em Limit ($0.50/$1.00) - 2006/10/28 - 23:03:18 (ET)
Table 'Tanina' 10-max Seat #1 is the button
Seat 1: JMAC60 ($37.55 in chips) 
Seat 3: wpcrso ($8.85 in chips) 
Seat 5: call_me_pug ($21.35 in chips) 
Seat 6: OCbarrister ($14.50 in chips) 
Seat 7: Moooose ($29.45 in chips) 
Seat 8: 1,1,2,3,5 ($28.55 in chips) 
Seat 9: AOSD ($17.50 in chips) 
Seat 10: 1nyyfan ($41.50 in chips) 
wpcrso: posts small blind $0.25
MrKGBoreoman: is sitting out 
call_me_pug: posts big blind $0.50
*** HOLE CARDS ***
Dealt to 1,1,2,3,5 [8c 9d]
OCbarrister: calls $0.50
Moooose: folds 
1,1,2,3,5: folds 
AOSD: folds 
1nyyfan: folds 
JMAC60: calls $0.50
wpcrso: folds 
call_me_pug: checks 
*** FLOP *** [Th 5c Js]
call_me_pug: checks 
OCbarrister: checks 
JMAC60: checks 
*** TURN *** [Th 5c Js] [6h]
call_me_pug: checks 
OCbarrister: checks 
JMAC60: checks 
*** RIVER *** [Th 5c Js 6h] [Qc]
call_me_pug: checks 
OCbarrister: checks 
JMAC60: bets $1
call_me_pug: folds 
OCbarrister: folds 
JMAC60 collected $1.70 from pot
JMAC60: doesn't show hand 
*** SUMMARY ***
Total pot $1.75 | Rake $0.05 
Board [Th 5c Js 6h Qc]
Seat 1: JMAC60 (button) collected ($1.70)
Seat 3: wpcrso (small blind) folded before Flop
Seat 5: call_me_pug (big blind) folded on the River
Seat 6: OCbarrister folded on the River
Seat 7: Moooose folded before Flop (didn't bet)
Seat 8: 1,1,2,3,5 folded before Flop (didn't bet)
Seat 9: AOSD folded before Flop (didn't bet)
Seat 10: 1nyyfan folded before Flop (didn't bet)



PokerStars Game #6809271668:  Hold'em Limit ($0.50/$1.00) - 2006/10/28 - 23:04:04 (ET)
Table 'Tanina' 10-max Seat #3 is the button
Seat 1: JMAC60 ($38.75 in chips) 
Seat 3: wpcrso ($8.60 in chips) 
Seat 5: call_me_pug ($20.85 in chips) 
Seat 6: OCbarrister ($14 in chips) 
Seat 7: Moooose ($29.45 in chips) 
Seat 8: 1,1,2,3,5 ($28.55 in chips) 
Seat 9: AOSD ($17.50 in chips) 
Seat 10: 1nyyfan ($41.50 in chips) 
call_me_pug: posts small blind $0.25
OCbarrister: posts big blind $0.50
*** HOLE CARDS ***
Dealt to 1,1,2,3,5 [Jc Qs]
Moooose: folds 
1,1,2,3,5: folds 
AOSD: folds 
1nyyfan: folds 
JMAC60: calls $0.50
wpcrso: raises $0.50 to $1
call_me_pug: folds 
OCbarrister: calls $0.50
JMAC60: calls $0.50
*** FLOP *** [4d 5d Ks]
call_me_pug leaves the table
OCbarrister: checks 
JMAC60: bets $0.50
wpcrso: raises $0.50 to $1
OCbarrister: folds 
JMAC60: calls $0.50
*** TURN *** [4d 5d Ks] [3s]
JMAC60: checks 
wpcrso: bets $1
JMAC60: calls $1
*** RIVER *** [4d 5d Ks 3s] [2d]
JMAC60: checks 
wpcrso: bets $1
JMAC60: raises $1 to $2
wpcrso: raises $1 to $3
JMAC60: raises $1 to $4
Betting is capped
wpcrso: calls $1
*** SHOW DOWN ***
JMAC60: shows [Kd 8d] (a flush, King high)
wpcrso: shows [Qd Ad] (a flush, Ace high)
wpcrso collected $14.75 from pot
*** SUMMARY ***
Total pot $15.25 | Rake $0.50 
Board [4d 5d Ks 3s 2d]
Seat 1: JMAC60 showed [Kd 8d] and lost with a flush, King high
Seat 3: wpcrso (button) showed [Qd Ad] and won ($14.75) with a flush, Ace high
Seat 5: call_me_pug (small blind) folded before Flop
Seat 6: OCbarrister (big blind) folded on the Flop
Seat 7: Moooose folded before Flop (didn't bet)
Seat 8: 1,1,2,3,5 folded before Flop (didn't bet)
Seat 9: AOSD folded before Flop (didn't bet)
Seat 10: 1nyyfan folded before Flop (didn't bet)



PokerStars Game #6809282827:  Hold'em Limit ($0.50/$1.00) - 2006/10/28 - 23:04:54 (ET)
Table 'Tanina' 10-max Seat #6 is the button
Seat 1: JMAC60 ($31.75 in chips) 
Seat 3: wpcrso ($16.35 in chips) 
Seat 6: OCbarrister ($13 in chips) 
Seat 7: Moooose ($29.45 in chips) 
Seat 8: 1,1,2,3,5 ($28.55 in chips) 
Seat 9: AOSD ($17.50 in chips) 
Seat 10: 1nyyfan ($41.50 in chips) 
Moooose: posts small blind $0.25
1,1,2,3,5: posts big blind $0.50
*** HOLE CARDS ***
Dealt to 1,1,2,3,5 [4h 4c]
AOSD: folds 
1nyyfan: folds 
JMAC60: calls $0.50
wpcrso: folds 
OCbarrister: folds 
Moooose: folds 
1,1,2,3,5: checks 
*** FLOP *** [7h 9h Qd]
Turkey1001 joins the table at seat #5 
1,1,2,3,5: checks 
JMAC60: bets $0.50
1,1,2,3,5: folds 
JMAC60 collected $1.20 from pot
JMAC60: doesn't show hand 
*** SUMMARY ***
Total pot $1.25 | Rake $0.05 
Board [7h 9h Qd]
Seat 1: JMAC60 collected ($1.20)
Seat 3: wpcrso folded before Flop (didn't bet)
Seat 6: OCbarrister (button) folded before Flop (didn't bet)
Seat 7: Moooose (small blind) folded before Flop
Seat 8: 1,1,2,3,5 (big blind) folded on the Flop
Seat 9: AOSD folded before Flop (didn't bet)
Seat 10: 1nyyfan folded before Flop (didn't bet)



PokerStars Game #6809289695:  Hold'em Limit ($0.50/$1.00) - 2006/10/28 - 23:05:25 (ET)
Table 'Tanina' 10-max Seat #7 is the button
Seat 1: JMAC60 ($32.45 in chips) 
Seat 3: wpcrso ($16.35 in chips) 
Seat 6: OCbarrister ($13 in chips) 
Seat 7: Moooose ($29.20 in chips) 
Seat 8: 1,1,2,3,5 ($28.05 in chips) 
Seat 9: AOSD ($17.50 in chips) 
Seat 10: 1nyyfan ($41.50 in chips) 
1,1,2,3,5: posts small blind $0.25
AOSD: posts big blind $0.50
Turkey1001: sits out 
*** HOLE CARDS ***
Dealt to 1,1,2,3,5 [9c 6s]
1nyyfan: folds 
JMAC60: folds 
wpcrso: folds 
OCbarrister: calls $0.50
Moooose: calls $0.50
1,1,2,3,5: folds 
AOSD: checks 
*** FLOP *** [Tc 3h Qs]
AOSD: checks 
OCbarrister: checks 
Moooose: checks 
*** TURN *** [Tc 3h Qs] [5d]
AOSD: bets $1
OCbarrister: folds 
Moooose: folds 
AOSD collected $1.70 from pot
*** SUMMARY ***
Total pot $1.75 | Rake $0.05 
Board [Tc 3h Qs 5d]
Seat 1: JMAC60 folded before Flop (didn't bet)
Seat 3: wpcrso folded before Flop (didn't bet)
Seat 6: OCbarrister folded on the Turn
Seat 7: Moooose (button) folded on the Turn
Seat 8: 1,1,2,3,5 (small blind) folded before Flop
Seat 9: AOSD (big blind) collected ($1.70)
Seat 10: 1nyyfan folded before Flop (didn't bet)



PokerStars Game #6809296107:  Hold'em Limit ($0.50/$1.00) - 2006/10/28 - 23:05:54 (ET)
Table 'Tanina' 10-max Seat #8 is the button
Seat 1: JMAC60 ($32.45 in chips) 
Seat 3: wpcrso ($16.35 in chips) 
Seat 5: Turkey1001 ($20 in chips) 
Seat 6: OCbarrister ($12.50 in chips) 
Seat 7: Moooose ($28.70 in chips) 
Seat 8: 1,1,2,3,5 ($27.80 in chips) 
Seat 9: AOSD ($18.70 in chips) 
Seat 10: 1nyyfan ($41.50 in chips) 
AOSD: posts small blind $0.25
1nyyfan: posts big blind $0.50
Turkey1001: posts big blind $0.50
*** HOLE CARDS ***
Dealt to 1,1,2,3,5 [5c 2s]
JMAC60: folds 
wpcrso: folds 
Turkey1001: checks 
OCbarrister: calls $0.50
Moooose: folds 
1,1,2,3,5: folds 
AOSD: folds 
1nyyfan: checks 
*** FLOP *** [6d 9s 5d]
1nyyfan: checks 
Turkey1001: checks 
OCbarrister: checks 
*** TURN *** [6d 9s 5d] [8h]
1nyyfan: checks 
Turkey1001: bets $1
OCbarrister: calls $1
1nyyfan: folds 
*** RIVER *** [6d 9s 5d 8h] [Ts]
Turkey1001: bets $1
OCbarrister: calls $1
*** SHOW DOWN ***
Turkey1001: shows [4c 6s] (a pair of Sixes)
OCbarrister: shows [Kc 7c] (a straight, Six to Ten)
OCbarrister collected $5.50 from pot
*** SUMMARY ***
Total pot $5.75 | Rake $0.25 
Board [6d 9s 5d 8h Ts]
Seat 1: JMAC60 folded before Flop (didn't bet)
Seat 3: wpcrso folded before Flop (didn't bet)
Seat 5: Turkey1001 showed [4c 6s] and lost with a pair of Sixes
Seat 6: OCbarrister showed [Kc 7c] and won ($5.50) with a straight, Six to Ten
Seat 7: Moooose folded before Flop (didn't bet)
Seat 8: 1,1,2,3,5 (button) folded before Flop (didn't bet)
Seat 9: AOSD (small blind) folded before Flop
Seat 10: 1nyyfan (big blind) folded on the Turn



PokerStars Game #6809304337:  Hold'em Limit ($0.50/$1.00) - 2006/10/28 - 23:06:31 (ET)
Table 'Tanina' 10-max Seat #9 is the button
Seat 1: JMAC60 ($32.45 in chips) 
Seat 3: wpcrso ($16.35 in chips) 
Seat 5: Turkey1001 ($17.50 in chips) 
Seat 6: OCbarrister ($15.50 in chips) 
Seat 7: Moooose ($28.70 in chips) 
Seat 8: 1,1,2,3,5 ($27.80 in chips) 
Seat 9: AOSD ($18.45 in chips) 
Seat 10: 1nyyfan ($41 in chips) 
1nyyfan: posts small blind $0.25
JMAC60: posts big blind $0.50
*** HOLE CARDS ***
Dealt to 1,1,2,3,5 [Kc 6c]
wpcrso: folds 
Turkey1001: folds 
OCbarrister: folds 
Moooose: folds 
1,1,2,3,5: calls $0.50
AOSD: calls $0.50
1nyyfan: folds 
JMAC60: checks 
*** FLOP *** [5h Jc Ks]
JMAC60: checks 
1,1,2,3,5: checks 
AOSD: checks 
*** TURN *** [5h Jc Ks] [6h]
JMAC60: bets $1
1,1,2,3,5: raises $1 to $2
AOSD: folds 
JMAC60: calls $1
*** RIVER *** [5h Jc Ks 6h] [3c]
JMAC60: checks 
1,1,2,3,5: checks 
*** SHOW DOWN ***
JMAC60: shows [7s Kd] (a pair of Kings)
1,1,2,3,5: shows [Kc 6c] (two pair, Kings and Sixes)
1,1,2,3,5 collected $5.50 from pot
*** SUMMARY ***
Total pot $5.75 | Rake $0.25 
Board [5h Jc Ks 6h 3c]
Seat 1: JMAC60 (big blind) showed [7s Kd] and lost with a pair of Kings
Seat 3: wpcrso folded before Flop (didn't bet)
Seat 5: Turkey1001 folded before Flop (didn't bet)
Seat 6: OCbarrister folded before Flop (didn't bet)
Seat 7: Moooose folded before Flop (didn't bet)
Seat 8: 1,1,2,3,5 showed [Kc 6c] and won ($5.50) with two pair, Kings and Sixes
Seat 9: AOSD (button) folded on the Turn
Seat 10: 1nyyfan (small blind) folded before Flop



PokerStars Game #6809313029:  Hold'em Limit ($0.50/$1.00) - 2006/10/28 - 23:07:10 (ET)
Table 'Tanina' 10-max Seat #10 is the button
Seat 1: JMAC60 ($29.95 in chips) 
Seat 3: wpcrso ($16.35 in chips) 
Seat 5: Turkey1001 ($17.50 in chips) 
Seat 6: OCbarrister ($15.50 in chips) 
Seat 7: Moooose ($28.70 in chips) 
Seat 8: 1,1,2,3,5 ($30.80 in chips) 
Seat 9: AOSD ($17.95 in chips) 
Seat 10: 1nyyfan ($40.75 in chips) 
JMAC60: posts small blind $0.25
wpcrso: posts big blind $0.50
*** HOLE CARDS ***
Dealt to 1,1,2,3,5 [2s Ts]
Turkey1001: folds 
OCbarrister: folds 
Moooose: folds 
1,1,2,3,5: folds 
AOSD: folds 
1nyyfan: calls $0.50
JMAC60: folds 
wpcrso: checks 
*** FLOP *** [5h 8d 2d]
wpcrso: checks 
1nyyfan: bets $0.50
wpcrso: folds 
1nyyfan collected $1.20 from pot
*** SUMMARY ***
Total pot $1.25 | Rake $0.05 
Board [5h 8d 2d]
Seat 1: JMAC60 (small blind) folded before Flop
Seat 3: wpcrso (big blind) folded on the Flop
Seat 5: Turkey1001 folded before Flop (didn't bet)
Seat 6: OCbarrister folded before Flop (didn't bet)
Seat 7: Moooose folded before Flop (didn't bet)
Seat 8: 1,1,2,3,5 folded before Flop (didn't bet)
Seat 9: AOSD folded before Flop (didn't bet)
Seat 10: 1nyyfan (button) collected ($1.20)



PokerStars Game #6809320224:  Hold'em Limit ($0.50/$1.00) - 2006/10/28 - 23:07:42 (ET)
Table 'Tanina' 10-max Seat #1 is the button
Seat 1: JMAC60 ($29.70 in chips) 
Seat 3: wpcrso ($15.85 in chips) 
Seat 5: Turkey1001 ($17.50 in chips) 
Seat 6: OCbarrister ($15.50 in chips) 
Seat 7: Moooose ($28.70 in chips) 
Seat 8: 1,1,2,3,5 ($30.80 in chips) 
Seat 9: AOSD ($17.95 in chips) 
Seat 10: 1nyyfan ($41.45 in chips) 
JUNin was removed from the table for failing to post
wpcrso: posts small blind $0.25
Turkey1001: posts big blind $0.50
*** HOLE CARDS ***
Dealt to 1,1,2,3,5 [Qd Th]
OCbarrister: folds 
Moooose: folds 
1,1,2,3,5: calls $0.50
AOSD: folds 
1nyyfan: folds 
JMAC60: folds 
wpcrso: folds 
Turkey1001: checks 
*** FLOP *** [Qh 8c 3d]
Turkey1001: checks 
1,1,2,3,5: bets $0.50
Turkey1001: folds 
Redman102 joins the table at seat #2 
1,1,2,3,5 collected $1.20 from pot
1,1,2,3,5: doesn't show hand 
*** SUMMARY ***
Total pot $1.25 | Rake $0.05 
Board [Qh 8c 3d]
Seat 1: JMAC60 (button) folded before Flop (didn't bet)
Seat 3: wpcrso (small blind) folded before Flop
Seat 5: Turkey1001 (big blind) folded on the Flop
Seat 6: OCbarrister folded before Flop (didn't bet)
Seat 7: Moooose folded before Flop (didn't bet)
Seat 8: 1,1,2,3,5 collected ($1.20)
Seat 9: AOSD folded before Flop (didn't bet)
Seat 10: 1nyyfan folded before Flop (didn't bet)



PokerStars Game #6809326539:  Hold'em Limit ($0.50/$1.00) - 2006/10/28 - 23:08:11 (ET)
Table 'Tanina' 10-max Seat #3 is the button
Seat 1: JMAC60 ($29.70 in chips) 
Seat 3: wpcrso ($15.60 in chips) 
Seat 5: Turkey1001 ($17 in chips) 
Seat 6: OCbarrister ($15.50 in chips) 
Seat 7: Moooose ($28.70 in chips) 
Seat 8: 1,1,2,3,5 ($31.50 in chips) 
Seat 9: AOSD ($17.95 in chips) 
Seat 10: 1nyyfan ($41.45 in chips) 
Turkey1001: posts small blind $0.25
OCbarrister: posts big blind $0.50
Redman102: sits out 
*** HOLE CARDS ***
Dealt to 1,1,2,3,5 [3h 9c]
MrKGBoreoman leaves the table
Moooose: calls $0.50
1,1,2,3,5: folds 
AOSD: calls $0.50
1nyyfan: folds 
JMAC60: folds 
wpcrso: folds 
Turkey1001: calls $0.25
OCbarrister: checks 
*** FLOP *** [Js 6d Qh]
Turkey1001: checks 
OCbarrister: checks 
Moooose: bets $0.50
AOSD: folds 
Turkey1001: calls $0.50
OCbarrister: calls $0.50
*** TURN *** [Js 6d Qh] [8c]
Turkey1001: checks 
OCbarrister: checks 
Moooose: bets $1
Turkey1001: calls $1
OCbarrister: calls $1
*** RIVER *** [Js 6d Qh 8c] [3d]
Turkey1001: checks 
OCbarrister: checks 
Moooose: bets $1
Turkey1001: folds 
OCbarrister: calls $1
*** SHOW DOWN ***
Moooose: shows [Qd Jd] (two pair, Queens and Jacks)
OCbarrister: mucks hand 
Moooose collected $8.10 from pot
*** SUMMARY ***
Total pot $8.50 | Rake $0.40 
Board [Js 6d Qh 8c 3d]
Seat 1: JMAC60 folded before Flop (didn't bet)
Seat 3: wpcrso (button) folded before Flop (didn't bet)
Seat 5: Turkey1001 (small blind) folded on the River
Seat 6: OCbarrister (big blind) mucked [Kh Qs]
Seat 7: Moooose showed [Qd Jd] and won ($8.10) with two pair, Queens and Jacks
Seat 8: 1,1,2,3,5 folded before Flop (didn't bet)
Seat 9: AOSD folded on the Flop
Seat 10: 1nyyfan folded before Flop (didn't bet)



PokerStars Game #6809340368:  Hold'em Limit ($0.50/$1.00) - 2006/10/28 - 23:09:13 (ET)
Table 'Tanina' 10-max Seat #5 is the button
Seat 1: JMAC60 ($29.70 in chips) 
Seat 3: wpcrso ($15.60 in chips) 
Seat 5: Turkey1001 ($15 in chips) 
Seat 6: OCbarrister ($12.50 in chips) 
Seat 7: Moooose ($33.80 in chips) 
Seat 8: 1,1,2,3,5 ($31.50 in chips) 
Seat 9: AOSD ($17.45 in chips) 
Seat 10: 1nyyfan ($41.45 in chips) 
OCbarrister: posts small blind $0.25
Moooose: posts big blind $0.50
Redman102: sits out 
*** HOLE CARDS ***
Dealt to 1,1,2,3,5 [7h 2c]
1,1,2,3,5: folds 
AOSD: calls $0.50
1nyyfan: folds 
JMAC60: folds 
wpcrso: calls $0.50
Turkey1001: calls $0.50
OCbarrister: calls $0.25
Moooose: checks 
*** FLOP *** [Kd 2s Jc]
OCbarrister: checks 
Moooose: checks 
AOSD: checks 
wpcrso: bets $0.50
Turkey1001: folds 
OCbarrister: folds 
Moooose: folds 
AOSD: folds 
wpcrso collected $2.40 from pot
wpcrso: doesn't show hand 
*** SUMMARY ***
Total pot $2.50 | Rake $0.10 
Board [Kd 2s Jc]
Seat 1: JMAC60 folded before Flop (didn't bet)
Seat 3: wpcrso collected ($2.40)
Seat 5: Turkey1001 (button) folded on the Flop
Seat 6: OCbarrister (small blind) folded on the Flop
Seat 7: Moooose (big blind) folded on the Flop
Seat 8: 1,1,2,3,5 folded before Flop (didn't bet)
Seat 9: AOSD folded on the Flop
Seat 10: 1nyyfan folded before Flop (didn't bet)



PokerStars Game #6809349753:  Hold'em Limit ($0.50/$1.00) - 2006/10/28 - 23:09:55 (ET)
Table 'Tanina' 10-max Seat #6 is the button
Seat 1: JMAC60 ($29.70 in chips) 
Seat 3: wpcrso ($17.50 in chips) 
Seat 5: Turkey1001 ($14.50 in chips) 
Seat 6: OCbarrister ($12 in chips) 
Seat 7: Moooose ($33.30 in chips) 
Seat 8: 1,1,2,3,5 ($31.50 in chips) 
Seat 9: AOSD ($16.95 in chips) 
Seat 10: 1nyyfan ($41.45 in chips) 
Moooose: posts small blind $0.25
1,1,2,3,5: posts big blind $0.50
Redman102: sits out 
*** HOLE CARDS ***
Dealt to 1,1,2,3,5 [Jc Ah]
AOSD: calls $0.50
1nyyfan: calls $0.50
JMAC60: folds 
wpcrso: calls $0.50
Turkey1001: folds 
OCbarrister: folds 
Moooose: calls $0.25
1,1,2,3,5: raises $0.50 to $1
AOSD: calls $0.50
1nyyfan: calls $0.50
wpcrso: calls $0.50
Moooose: calls $0.50
*** FLOP *** [Ad 8h 9h]
Moooose: checks 
1,1,2,3,5: checks 
AOSD: checks 
1nyyfan: checks 
wpcrso: checks 
*** TURN *** [Ad 8h 9h] [Qc]
Moooose: checks 
1,1,2,3,5: checks 
AOSD: checks 
1nyyfan: checks 
wpcrso: checks 
*** RIVER *** [Ad 8h 9h Qc] [6h]
Moooose: checks 
1,1,2,3,5: bets $1
AOSD: folds 
1nyyfan: folds 
wpcrso: folds 
Moooose: folds 
1,1,2,3,5 collected $4.75 from pot
1,1,2,3,5: doesn't show hand 
*** SUMMARY ***
Total pot $5 | Rake $0.25 
Board [Ad 8h 9h Qc 6h]
Seat 1: JMAC60 folded before Flop (didn't bet)
Seat 3: wpcrso folded on the River
Seat 5: Turkey1001 folded before Flop (didn't bet)
Seat 6: OCbarrister (button) folded before Flop (didn't bet)
Seat 7: Moooose (small blind) folded on the River
Seat 8: 1,1,2,3,5 (big blind) collected ($4.75)
Seat 9: AOSD folded on the River
Seat 10: 1nyyfan folded on the River



PokerStars Game #6809362382:  Hold'em Limit ($0.50/$1.00) - 2006/10/28 - 23:10:53 (ET)
Table 'Tanina' 10-max Seat #7 is the button
Seat 1: JMAC60 ($29.70 in chips) 
Seat 3: wpcrso ($16.50 in chips) 
Seat 5: Turkey1001 ($14.50 in chips) 
Seat 6: OCbarrister ($12 in chips) 
Seat 7: Moooose ($32.30 in chips) 
Seat 8: 1,1,2,3,5 ($35.25 in chips) 
Seat 9: AOSD ($15.95 in chips) 
Seat 10: 1nyyfan ($40.45 in chips) 
1,1,2,3,5: posts small blind $0.25
AOSD: posts big blind $0.50
Redman102: sits out 
*** HOLE CARDS ***
Dealt to 1,1,2,3,5 [4s 8s]
1nyyfan: folds 
JMAC60: folds 
wpcrso: folds 
Turkey1001: raises $0.50 to $1
OCbarrister: folds 
Moooose: folds 
1,1,2,3,5: folds 
AOSD: calls $0.50
*** FLOP *** [7s Qd 7h]
AOSD: checks 
Turkey1001: bets $0.50
Scylla joins the table at seat #4 
AOSD: folds 
Turkey1001 collected $2.15 from pot
*** SUMMARY ***
Total pot $2.25 | Rake $0.10 
Board [7s Qd 7h]
Seat 1: JMAC60 folded before Flop (didn't bet)
Seat 3: wpcrso folded before Flop (didn't bet)
Seat 5: Turkey1001 collected ($2.15)
Seat 6: OCbarrister folded before Flop (didn't bet)
Seat 7: Moooose (button) folded before Flop (didn't bet)
Seat 8: 1,1,2,3,5 (small blind) folded before Flop
Seat 9: AOSD (big blind) folded on the Flop
Seat 10: 1nyyfan folded before Flop (didn't bet)



PokerStars Game #6809372126:  Hold'em Limit ($0.50/$1.00) - 2006/10/28 - 23:11:37 (ET)
Table 'Tanina' 10-max Seat #8 is the button
Seat 1: JMAC60 ($29.70 in chips) 
Seat 3: wpcrso ($16.50 in chips) 
Seat 5: Turkey1001 ($15.65 in chips) 
Seat 6: OCbarrister ($12 in chips) 
Seat 7: Moooose ($32.30 in chips) 
Seat 8: 1,1,2,3,5 ($35 in chips) 
Seat 9: AOSD ($14.95 in chips) 
Seat 10: 1nyyfan ($40.45 in chips) 
AOSD: posts small blind $0.25
1nyyfan: posts big blind $0.50
Redman102: sits out 
Scylla: sits out 
*** HOLE CARDS ***
Dealt to 1,1,2,3,5 [6h 8s]
JMAC60: folds 
wpcrso: folds 
Turkey1001: raises $0.50 to $1
OCbarrister: folds 
Moooose: folds 
1,1,2,3,5: folds 
AOSD: folds 
1nyyfan: calls $0.50
*** FLOP *** [2c Kh 5c]
1nyyfan: checks 
Turkey1001: bets $0.50
1nyyfan: calls $0.50
*** TURN *** [2c Kh 5c] [Ks]
1nyyfan: checks 
Turkey1001: bets $1
1nyyfan: calls $1
*** RIVER *** [2c Kh 5c Ks] [2s]
1nyyfan: checks 
Turkey1001: bets $1
1nyyfan: folds 
Turkey1001 collected $5 from pot
*** SUMMARY ***
Total pot $5.25 | Rake $0.25 
Board [2c Kh 5c Ks 2s]
Seat 1: JMAC60 folded before Flop (didn't bet)
Seat 3: wpcrso folded before Flop (didn't bet)
Seat 5: Turkey1001 collected ($5)
Seat 6: OCbarrister folded before Flop (didn't bet)
Seat 7: Moooose folded before Flop (didn't bet)
Seat 8: 1,1,2,3,5 (button) folded before Flop (didn't bet)
Seat 9: AOSD (small blind) folded before Flop
Seat 10: 1nyyfan (big blind) folded on the River



PokerStars Game #6809380317:  Hold'em Limit ($0.50/$1.00) - 2006/10/28 - 23:12:14 (ET)
Table 'Tanina' 10-max Seat #9 is the button
Seat 1: JMAC60 ($29.70 in chips) 
Seat 3: wpcrso ($16.50 in chips) 
Seat 5: Turkey1001 ($18.15 in chips) 
Seat 6: OCbarrister ($12 in chips) 
Seat 7: Moooose ($32.30 in chips) 
Seat 8: 1,1,2,3,5 ($35 in chips) 
Seat 9: AOSD ($14.70 in chips) 
Seat 10: 1nyyfan ($37.95 in chips) 
1nyyfan: posts small blind $0.25
JMAC60: posts big blind $0.50
Redman102: sits out 
Scylla: sits out 
*** HOLE CARDS ***
Dealt to 1,1,2,3,5 [7s Kh]
wpcrso: folds 
Turkey1001: calls $0.50
OCbarrister: folds 
Moooose: folds 
1,1,2,3,5: folds 
AOSD: folds 
1nyyfan: folds 
JMAC60: checks 
*** FLOP *** [8d Ks 5s]
JMAC60: checks 
Turkey1001: checks 
*** TURN *** [8d Ks 5s] [Qc]
JMAC60: checks 
Turkey1001: bets $1
JMAC60: folds 
Turkey1001 collected $1.20 from pot
*** SUMMARY ***
Total pot $1.25 | Rake $0.05 
Board [8d Ks 5s Qc]
Seat 1: JMAC60 (big blind) folded on the Turn
Seat 3: wpcrso folded before Flop (didn't bet)
Seat 5: Turkey1001 collected ($1.20)
Seat 6: OCbarrister folded before Flop (didn't bet)
Seat 7: Moooose folded before Flop (didn't bet)
Seat 8: 1,1,2,3,5 folded before Flop (didn't bet)
Seat 9: AOSD (button) folded before Flop (didn't bet)
Seat 10: 1nyyfan (small blind) folded before Flop



PokerStars Game #6809386828:  Hold'em Limit ($0.50/$1.00) - 2006/10/28 - 23:12:43 (ET)
Table 'Tanina' 10-max Seat #10 is the button
Seat 1: JMAC60 ($29.20 in chips) 
Seat 2: Redman102 ($15 in chips) 
Seat 3: wpcrso ($16.50 in chips) 
Seat 5: Turkey1001 ($18.85 in chips) 
Seat 6: OCbarrister ($12 in chips) 
Seat 7: Moooose ($32.30 in chips) 
Seat 8: 1,1,2,3,5 ($35 in chips) 
Seat 9: AOSD ($14.70 in chips) 
Seat 10: 1nyyfan ($37.70 in chips) 
JMAC60: posts small blind $0.25
Redman102: posts big blind $0.50
Scylla: sits out 
*** HOLE CARDS ***
Dealt to 1,1,2,3,5 [5c 7s]
wpcrso: folds 
Turkey1001: folds 
OCbarrister: folds 
Moooose: folds 
1,1,2,3,5: folds 
AOSD: folds 
1nyyfan: calls $0.50
JMAC60: calls $0.25
Redman102: raises $0.50 to $1
1nyyfan: calls $0.50
JMAC60: calls $0.50
*** FLOP *** [9h Ah Ts]
JMAC60: checks 
Redman102: bets $0.50
1nyyfan: raises $0.50 to $1
JMAC60: calls $1
Redman102: calls $0.50
*** TURN *** [9h Ah Ts] [5s]
JMAC60: checks 
Redman102: checks 
1nyyfan: bets $1
JMAC60: calls $1
Redman102: folds 
*** RIVER *** [9h Ah Ts 5s] [3h]
JMAC60: bets $1
1nyyfan: calls $1
*** SHOW DOWN ***
JMAC60: shows [6h Th] (a flush, Ace high)
1nyyfan: shows [Ad Ac] (three of a kind, Aces)
JMAC60 collected $9.55 from pot
*** SUMMARY ***
Total pot $10 | Rake $0.45 
Board [9h Ah Ts 5s 3h]
Seat 1: JMAC60 (small blind) showed [6h Th] and won ($9.55) with a flush, Ace high
Seat 2: Redman102 (big blind) folded on the Turn
Seat 3: wpcrso folded before Flop (didn't bet)
Seat 5: Turkey1001 folded before Flop (didn't bet)
Seat 6: OCbarrister folded before Flop (didn't bet)
Seat 7: Moooose folded before Flop (didn't bet)
Seat 8: 1,1,2,3,5 folded before Flop (didn't bet)
Seat 9: AOSD folded before Flop (didn't bet)
Seat 10: 1nyyfan (button) showed [Ad Ac] and lost with three of a kind, Aces



PokerStars Game #6809402622:  Hold'em Limit ($0.50/$1.00) - 2006/10/28 - 23:13:55 (ET)
Table 'Tanina' 10-max Seat #1 is the button
Seat 1: JMAC60 ($34.75 in chips) 
Seat 2: Redman102 ($13 in chips) 
Seat 3: wpcrso ($16.50 in chips) 
Seat 5: Turkey1001 ($18.85 in chips) 
Seat 6: OCbarrister ($12 in chips) 
Seat 7: Moooose ($32.30 in chips) 
Seat 8: 1,1,2,3,5 ($35 in chips) 
Seat 9: AOSD ($14.70 in chips) 
Seat 10: 1nyyfan ($33.70 in chips) 
Redman102: posts small blind $0.25
wpcrso: posts big blind $0.50
Scylla: sits out 
*** HOLE CARDS ***
Dealt to 1,1,2,3,5 [7s Td]
Turkey1001: folds 
OCbarrister: folds 
Moooose: calls $0.50
1,1,2,3,5: folds 
AOSD: folds 
1nyyfan: folds 
JMAC60: folds 
Redman102: calls $0.25
wpcrso: checks 
*** FLOP *** [9h 8d Kh]
Redman102: bets $0.50
wpcrso: folds 
Moooose: calls $0.50
*** TURN *** [9h 8d Kh] [Th]
Redman102: bets $1
Moooose: folds 
Redman102 collected $2.40 from pot
*** SUMMARY ***
Total pot $2.50 | Rake $0.10 
Board [9h 8d Kh Th]
Seat 1: JMAC60 (button) folded before Flop (didn't bet)
Seat 2: Redman102 (small blind) collected ($2.40)
Seat 3: wpcrso (big blind) folded on the Flop
Seat 5: Turkey1001 folded before Flop (didn't bet)
Seat 6: OCbarrister folded before Flop (didn't bet)
Seat 7: Moooose folded on the Turn
Seat 8: 1,1,2,3,5 folded before Flop (didn't bet)
Seat 9: AOSD folded before Flop (didn't bet)
Seat 10: 1nyyfan folded before Flop (didn't bet)



PokerStars Game #6809412821:  Hold'em Limit ($0.50/$1.00) - 2006/10/28 - 23:14:41 (ET)
Table 'Tanina' 10-max Seat #2 is the button
Seat 1: JMAC60 ($34.75 in chips) 
Seat 2: Redman102 ($14.40 in chips) 
Seat 3: wpcrso ($16 in chips) 
Seat 4: Scylla ($18.90 in chips) 
Seat 5: Turkey1001 ($18.85 in chips) 
Seat 6: OCbarrister ($12 in chips) 
Seat 7: Moooose ($31.30 in chips) 
Seat 8: 1,1,2,3,5 ($35 in chips) 
Seat 9: AOSD ($14.70 in chips) 
Seat 10: 1nyyfan ($33.70 in chips) 
wpcrso: posts small blind $0.25
Scylla: posts big blind $0.50
*** HOLE CARDS ***
Dealt to 1,1,2,3,5 [8c 7d]
Turkey1001: folds 
OCbarrister: calls $0.50
Moooose: folds 
1,1,2,3,5: folds 
AOSD: folds 
1nyyfan: folds 
JMAC60: folds 
Redman102: raises $0.50 to $1
wpcrso: folds 
Scylla: folds 
OCbarrister: calls $0.50
*** FLOP *** [5d Qc Ad]
OCbarrister: checks 
Redman102: bets $0.50
OCbarrister: calls $0.50
*** TURN *** [5d Qc Ad] [Jd]
OCbarrister: checks 
Redman102: bets $1
OCbarrister: calls $1
*** RIVER *** [5d Qc Ad Jd] [Qs]
OCbarrister: checks 
Redman102: bets $1
OCbarrister: calls $1
*** SHOW DOWN ***
Redman102: shows [Jc Ac] (two pair, Aces and Queens)
OCbarrister: shows [3h Ah] (two pair, Aces and Queens)
OCbarrister collected $3.70 from pot
Redman102 collected $3.70 from pot
*** SUMMARY ***
Total pot $7.75 | Rake $0.35 
Board [5d Qc Ad Jd Qs]
Seat 1: JMAC60 folded before Flop (didn't bet)
Seat 2: Redman102 (button) showed [Jc Ac] and won ($3.70) with two pair, Aces and Queens
Seat 3: wpcrso (small blind) folded before Flop
Seat 4: Scylla (big blind) folded before Flop
Seat 5: Turkey1001 folded before Flop (didn't bet)
Seat 6: OCbarrister showed [3h Ah] and won ($3.70) with two pair, Aces and Queens
Seat 7: Moooose folded before Flop (didn't bet)
Seat 8: 1,1,2,3,5 folded before Flop (didn't bet)
Seat 9: AOSD folded before Flop (didn't bet)
Seat 10: 1nyyfan folded before Flop (didn't bet)



PokerStars Game #6809426603:  Hold'em Limit ($0.50/$1.00) - 2006/10/28 - 23:15:45 (ET)
Table 'Tanina' 10-max Seat #3 is the button
Seat 1: JMAC60 ($34.75 in chips) 
Seat 2: Redman102 ($14.60 in chips) 
Seat 3: wpcrso ($15.75 in chips) 
Seat 4: Scylla ($18.40 in chips) 
Seat 5: Turkey1001 ($18.85 in chips) 
Seat 6: OCbarrister ($12.20 in chips) 
Seat 7: Moooose ($31.30 in chips) 
Seat 8: 1,1,2,3,5 ($35 in chips) 
Seat 9: AOSD ($14.70 in chips) 
Seat 10: 1nyyfan ($33.70 in chips) 
Scylla: posts small blind $0.25
Turkey1001: posts big blind $0.50
*** HOLE CARDS ***
Dealt to 1,1,2,3,5 [4c 9c]
OCbarrister: calls $0.50
Moooose: calls $0.50
1,1,2,3,5: folds 
AOSD: calls $0.50
1nyyfan: folds 
JMAC60: calls $0.50
Redman102: folds 
wpcrso: folds 
Scylla: calls $0.25
Turkey1001: checks 
*** FLOP *** [7c Jh Ah]
Scylla: checks 
Turkey1001: bets $0.50
OCbarrister: folds 
Moooose: folds 
AOSD: calls $0.50
JMAC60: folds 
Scylla: calls $0.50
*** TURN *** [7c Jh Ah] [Td]
Scylla: checks 
Turkey1001: bets $1
AOSD: raises $1 to $2
Scylla: calls $2
Turkey1001: calls $1
*** RIVER *** [7c Jh Ah Td] [3h]
Scylla: checks 
Turkey1001: bets $1
AOSD: calls $1
Scylla: raises $1 to $2
Turkey1001: raises $1 to $3
AOSD: folds 
Scylla: calls $1
*** SHOW DOWN ***
Turkey1001: shows [Qh 8h] (a flush, Ace high)
Scylla: mucks hand 
Turkey1001 collected $17 from pot
*** SUMMARY ***
Total pot $17.50 | Rake $0.50 
Board [7c Jh Ah Td 3h]
Seat 1: JMAC60 folded on the Flop
Seat 2: Redman102 folded before Flop (didn't bet)
Seat 3: wpcrso (button) folded before Flop (didn't bet)
Seat 4: Scylla (small blind) mucked [Ts Jd]
Seat 5: Turkey1001 (big blind) showed [Qh 8h] and won ($17) with a flush, Ace high
Seat 6: OCbarrister folded on the Flop
Seat 7: Moooose folded on the Flop
Seat 8: 1,1,2,3,5 folded before Flop (didn't bet)
Seat 9: AOSD folded on the River
Seat 10: 1nyyfan folded before Flop (didn't bet)



PokerStars Game #6809441073:  Hold'em Limit ($0.50/$1.00) - 2006/10/28 - 23:16:52 (ET)
Table 'Tanina' 10-max Seat #4 is the button
Seat 1: JMAC60 ($34.25 in chips) 
Seat 2: Redman102 ($14.60 in chips) 
Seat 3: wpcrso ($15.75 in chips) 
Seat 4: Scylla ($12.40 in chips) 
Seat 5: Turkey1001 ($29.85 in chips) 
Seat 6: OCbarrister ($11.70 in chips) 
Seat 7: Moooose ($30.80 in chips) 
Seat 8: 1,1,2,3,5 ($35 in chips) 
Seat 9: AOSD ($10.70 in chips) 
Seat 10: 1nyyfan ($33.70 in chips) 
Turkey1001: posts small blind $0.25
OCbarrister: posts big blind $0.50
*** HOLE CARDS ***
Dealt to 1,1,2,3,5 [4d 7c]
Moooose: folds 
1,1,2,3,5: folds 
AOSD: folds 
1nyyfan: folds 
JMAC60: folds 
Redman102: folds 
wpcrso: raises $0.50 to $1
Scylla: folds 
Turkey1001: folds 
OCbarrister: folds 
Scylla said, "nice hit"
wpcrso collected $1.25 from pot
wpcrso: doesn't show hand 
*** SUMMARY ***
Total pot $1.25 | Rake $0 
Seat 1: JMAC60 folded before Flop (didn't bet)
Seat 2: Redman102 folded before Flop (didn't bet)
Seat 3: wpcrso collected ($1.25)
Seat 4: Scylla (button) folded before Flop (didn't bet)
Seat 5: Turkey1001 (small blind) folded before Flop
Seat 6: OCbarrister (big blind) folded before Flop
Seat 7: Moooose folded before Flop (didn't bet)
Seat 8: 1,1,2,3,5 folded before Flop (didn't bet)
Seat 9: AOSD folded before Flop (didn't bet)
Seat 10: 1nyyfan folded before Flop (didn't bet)



PokerStars Game #6809445425:  Hold'em Limit ($0.50/$1.00) - 2006/10/28 - 23:17:12 (ET)
Table 'Tanina' 10-max Seat #5 is the button
Seat 1: JMAC60 ($34.25 in chips) 
Seat 2: Redman102 ($14.60 in chips) 
Seat 3: wpcrso ($16.50 in chips) 
Seat 4: Scylla ($12.40 in chips) 
Seat 5: Turkey1001 ($29.60 in chips) 
Seat 6: OCbarrister ($11.20 in chips) 
Seat 7: Moooose ($30.80 in chips) 
Seat 8: 1,1,2,3,5 ($35 in chips) 
Seat 9: AOSD ($10.70 in chips) 
Seat 10: 1nyyfan ($33.70 in chips) 
OCbarrister: posts small blind $0.25
Moooose: posts big blind $0.50
*** HOLE CARDS ***
Dealt to 1,1,2,3,5 [Qd Kc]
1,1,2,3,5: calls $0.50
AOSD: calls $0.50
1nyyfan: folds 
JMAC60: folds 
Redman102: folds 
wpcrso: calls $0.50
Scylla: folds 
Turkey1001: folds 
OCbarrister: calls $0.25
Moooose: checks 
*** FLOP *** [Ad 7h 2h]
OCbarrister: checks 
Moooose: bets $0.50
1,1,2,3,5: folds 
AOSD: folds 
wpcrso: raises $0.50 to $1
OCbarrister: folds 
Moooose: calls $0.50
*** TURN *** [Ad 7h 2h] [9c]
Moooose: checks 
wpcrso: bets $1
Moooose: calls $1
*** RIVER *** [Ad 7h 2h 9c] [9s]
Moooose: checks 
wpcrso: bets $1
Moooose: calls $1
*** SHOW DOWN ***
wpcrso: shows [7s 7d] (a full house, Sevens full of Nines)
Moooose: shows [As Qs] (two pair, Aces and Nines)
wpcrso collected $8.10 from pot
*** SUMMARY ***
Total pot $8.50 | Rake $0.40 
Board [Ad 7h 2h 9c 9s]
Seat 1: JMAC60 folded before Flop (didn't bet)
Seat 2: Redman102 folded before Flop (didn't bet)
Seat 3: wpcrso showed [7s 7d] and won ($8.10) with a full house, Sevens full of Nines
Seat 4: Scylla folded before Flop (didn't bet)
Seat 5: Turkey1001 (button) folded before Flop (didn't bet)
Seat 6: OCbarrister (small blind) folded on the Flop
Seat 7: Moooose (big blind) showed [As Qs] and lost with two pair, Aces and Nines
Seat 8: 1,1,2,3,5 folded on the Flop
Seat 9: AOSD folded on the Flop
Seat 10: 1nyyfan folded before Flop (didn't bet)



PokerStars Game #6809458693:  Hold'em Limit ($0.50/$1.00) - 2006/10/28 - 23:18:14 (ET)
Table 'Tanina' 10-max Seat #6 is the button
Seat 1: JMAC60 ($34.25 in chips) 
Seat 2: Redman102 ($14.60 in chips) 
Seat 3: wpcrso ($21.10 in chips) 
Seat 4: Scylla ($12.40 in chips) 
Seat 5: Turkey1001 ($29.60 in chips) 
Seat 6: OCbarrister ($10.70 in chips) 
Seat 7: Moooose ($27.30 in chips) 
Seat 8: 1,1,2,3,5 ($34.50 in chips) 
Seat 9: AOSD ($10.20 in chips) 
Seat 10: 1nyyfan ($33.70 in chips) 
Moooose: posts small blind $0.25
1,1,2,3,5: posts big blind $0.50
*** HOLE CARDS ***
Dealt to 1,1,2,3,5 [Qh Js]
AOSD: folds 
1nyyfan: folds 
JMAC60: folds 
Redman102: folds 
wpcrso: folds 
Scylla: folds 
Turkey1001: folds 
OCbarrister: calls $0.50
Moooose: folds 
1,1,2,3,5: checks 
*** FLOP *** [3s 5s 9s]
1,1,2,3,5: bets $0.50
OCbarrister: folds 
1,1,2,3,5 collected $1.20 from pot
1,1,2,3,5: doesn't show hand 
*** SUMMARY ***
Total pot $1.25 | Rake $0.05 
Board [3s 5s 9s]
Seat 1: JMAC60 folded before Flop (didn't bet)
Seat 2: Redman102 folded before Flop (didn't bet)
Seat 3: wpcrso folded before Flop (didn't bet)
Seat 4: Scylla folded before Flop (didn't bet)
Seat 5: Turkey1001 folded before Flop (didn't bet)
Seat 6: OCbarrister (button) folded on the Flop
Seat 7: Moooose (small blind) folded before Flop
Seat 8: 1,1,2,3,5 (big blind) collected ($1.20)
Seat 9: AOSD folded before Flop (didn't bet)
Seat 10: 1nyyfan folded before Flop (didn't bet)



PokerStars Game #6809464964:  Hold'em Limit ($0.50/$1.00) - 2006/10/28 - 23:18:43 (ET)
Table 'Tanina' 10-max Seat #7 is the button
Seat 1: JMAC60 ($34.25 in chips) 
Seat 2: Redman102 ($14.60 in chips) 
Seat 3: wpcrso ($21.10 in chips) 
Seat 4: Scylla ($12.40 in chips) 
Seat 5: Turkey1001 ($29.60 in chips) 
Seat 6: OCbarrister ($10.20 in chips) 
Seat 7: Moooose ($27.05 in chips) 
Seat 8: 1,1,2,3,5 ($35.20 in chips) 
Seat 9: AOSD ($10.20 in chips) 
Seat 10: 1nyyfan ($33.70 in chips) 
1,1,2,3,5: posts small blind $0.25
AOSD: posts big blind $0.50
*** HOLE CARDS ***
Dealt to 1,1,2,3,5 [7s 5c]
1nyyfan: calls $0.50
JMAC60: calls $0.50
Redman102: folds 
wpcrso: folds 
Scylla: calls $0.50
Turkey1001: calls $0.50
OCbarrister: folds 
Moooose: folds 
1,1,2,3,5: folds 
AOSD: checks 
*** FLOP *** [Th Qc Js]
AOSD: checks 
1nyyfan: checks 
JMAC60: bets $0.50
Scylla: calls $0.50
Turkey1001: calls $0.50
AOSD: folds 
1nyyfan: folds 
*** TURN *** [Th Qc Js] [9d]
JMAC60: bets $1
Scylla: folds 
Turkey1001: calls $1
*** RIVER *** [Th Qc Js 9d] [4d]
JMAC60: bets $1
Turkey1001: folds 
JMAC60 collected $5.95 from pot
JMAC60: doesn't show hand 
*** SUMMARY ***
Total pot $6.25 | Rake $0.30 
Board [Th Qc Js 9d 4d]
Seat 1: JMAC60 collected ($5.95)
Seat 2: Redman102 folded before Flop (didn't bet)
Seat 3: wpcrso folded before Flop (didn't bet)
Seat 4: Scylla folded on the Turn
Seat 5: Turkey1001 folded on the River
Seat 6: OCbarrister folded before Flop (didn't bet)
Seat 7: Moooose (button) folded before Flop (didn't bet)
Seat 8: 1,1,2,3,5 (small blind) folded before Flop
Seat 9: AOSD (big blind) folded on the Flop
Seat 10: 1nyyfan folded on the Flop



PokerStars Game #6809476740:  Hold'em Limit ($0.50/$1.00) - 2006/10/28 - 23:19:39 (ET)
Table 'Tanina' 10-max Seat #8 is the button
Seat 1: JMAC60 ($38.20 in chips) 
Seat 2: Redman102 ($14.60 in chips) 
Seat 3: wpcrso ($21.10 in chips) 
Seat 4: Scylla ($11.40 in chips) 
Seat 5: Turkey1001 ($27.60 in chips) 
Seat 6: OCbarrister ($10.20 in chips) 
Seat 7: Moooose ($27.05 in chips) 
Seat 8: 1,1,2,3,5 ($34.95 in chips) 
Seat 9: AOSD ($9.70 in chips) 
Seat 10: 1nyyfan ($33.20 in chips) 
AOSD: posts small blind $0.25
1nyyfan: posts big blind $0.50
*** HOLE CARDS ***
Dealt to 1,1,2,3,5 [5c 8c]
JMAC60: folds 
Redman102: folds 
wpcrso: folds 
Scylla: raises $0.50 to $1
Turkey1001: folds 
OCbarrister: folds 
Moooose: folds 
1,1,2,3,5: folds 
AOSD: folds 
1nyyfan: folds 
Scylla collected $1.25 from pot
Scylla: doesn't show hand 
*** SUMMARY ***
Total pot $1.25 | Rake $0 
Seat 1: JMAC60 folded before Flop (didn't bet)
Seat 2: Redman102 folded before Flop (didn't bet)
Seat 3: wpcrso folded before Flop (didn't bet)
Seat 4: Scylla collected ($1.25)
Seat 5: Turkey1001 folded before Flop (didn't bet)
Seat 6: OCbarrister folded before Flop (didn't bet)
Seat 7: Moooose folded before Flop (didn't bet)
Seat 8: 1,1,2,3,5 (button) folded before Flop (didn't bet)
Seat 9: AOSD (small blind) folded before Flop
Seat 10: 1nyyfan (big blind) folded before Flop



PokerStars Game #6809481413:  Hold'em Limit ($0.50/$1.00) - 2006/10/28 - 23:20:01 (ET)
Table 'Tanina' 10-max Seat #9 is the button
Seat 1: JMAC60 ($38.20 in chips) 
Seat 2: Redman102 ($14.60 in chips) 
Seat 3: wpcrso ($21.10 in chips) 
Seat 4: Scylla ($12.15 in chips) 
Seat 5: Turkey1001 ($27.60 in chips) 
Seat 6: OCbarrister ($10.20 in chips) 
Seat 7: Moooose ($27.05 in chips) 
Seat 8: 1,1,2,3,5 ($34.95 in chips) 
Seat 9: AOSD ($9.45 in chips) 
Seat 10: 1nyyfan ($32.70 in chips) 
1nyyfan: posts small blind $0.25
JMAC60: posts big blind $0.50
*** HOLE CARDS ***
Dealt to 1,1,2,3,5 [2s 8c]
Redman102 said, "oc still trying to figure ow I lost with AQ with J kicker"
Redman102: folds 
wpcrso: folds 
Scylla: calls $0.50
Turkey1001: folds 
OCbarrister: folds 
Moooose: calls $0.50
1,1,2,3,5: folds 
AOSD: raises $0.50 to $1
1nyyfan: folds 
JMAC60: calls $0.50
Redman102 said, "or tied"
Scylla: calls $0.50
Moooose: calls $0.50
*** FLOP *** [4s 8h Ks]
JMAC60: checks 
Scylla: checks 
Moooose: checks 
AOSD: checks 
*** TURN *** [4s 8h Ks] [9d]
JMAC60: bets $1
Scylla: folds 
Moooose: folds 
AOSD: folds 
JMAC60 collected $4.05 from pot
JMAC60: doesn't show hand 
*** SUMMARY ***
Total pot $4.25 | Rake $0.20 
Board [4s 8h Ks 9d]
Seat 1: JMAC60 (big blind) collected ($4.05)
Seat 2: Redman102 folded before Flop (didn't bet)
Seat 3: wpcrso folded before Flop (didn't bet)
Seat 4: Scylla folded on the Turn
Seat 5: Turkey1001 folded before Flop (didn't bet)
Seat 6: OCbarrister folded before Flop (didn't bet)
Seat 7: Moooose folded on the Turn
Seat 8: 1,1,2,3,5 folded before Flop (didn't bet)
Seat 9: AOSD (button) folded on the Turn
Seat 10: 1nyyfan (small blind) folded before Flop



PokerStars Game #6809496153:  Hold'em Limit ($0.50/$1.00) - 2006/10/28 - 23:21:10 (ET)
Table 'Tanina' 10-max Seat #10 is the button
Seat 1: JMAC60 ($41.25 in chips) 
Seat 2: Redman102 ($14.60 in chips) 
Seat 3: wpcrso ($21.10 in chips) 
Seat 4: Scylla ($11.15 in chips) 
Seat 5: Turkey1001 ($27.60 in chips) 
Seat 6: OCbarrister ($10.20 in chips) 
Seat 7: Moooose ($26.05 in chips) 
Seat 8: 1,1,2,3,5 ($34.95 in chips) 
Seat 9: AOSD ($8.45 in chips) 
Seat 10: 1nyyfan ($32.45 in chips) 
JMAC60: posts small blind $0.25
Redman102: posts big blind $0.50
*** HOLE CARDS ***
Dealt to 1,1,2,3,5 [9h 9s]
wpcrso: folds 
Scylla: calls $0.50
Turkey1001: folds 
OCbarrister: folds 
Moooose: folds 
1,1,2,3,5: raises $0.50 to $1
AOSD: folds 
1nyyfan: calls $1
JMAC60: folds 
Redman102: calls $0.50
Scylla: calls $0.50
*** FLOP *** [Kh Kd Qd]
Redman102: checks 
Scylla: checks 
1,1,2,3,5: bets $0.50
1nyyfan: calls $0.50
Redman102: folds 
Scylla: calls $0.50
*** TURN *** [Kh Kd Qd] [2s]
Scylla: checks 
1,1,2,3,5: checks 
Moooose said, "QQ on the board; so you both had AA/QQ w/ J kicker on the board"
1nyyfan: bets $1
Scylla: calls $1
1,1,2,3,5: folds 
*** RIVER *** [Kh Kd Qd 2s] [8c]
Scylla: checks 
1nyyfan: bets $1
Scylla: calls $1
*** SHOW DOWN ***
1nyyfan: shows [Kc Jd] (three of a kind, Kings)
Scylla: mucks hand 
1nyyfan collected $9.30 from pot
*** SUMMARY ***
Total pot $9.75 | Rake $0.45 
Board [Kh Kd Qd 2s 8c]
Seat 1: JMAC60 (small blind) folded before Flop
Seat 2: Redman102 (big blind) folded on the Flop
Seat 3: wpcrso folded before Flop (didn't bet)
Seat 4: Scylla mucked [Qs Jc]
Seat 5: Turkey1001 folded before Flop (didn't bet)
Seat 6: OCbarrister folded before Flop (didn't bet)
Seat 7: Moooose folded before Flop (didn't bet)
Seat 8: 1,1,2,3,5 folded on the Turn
Seat 9: AOSD folded before Flop (didn't bet)
Seat 10: 1nyyfan (button) showed [Kc Jd] and won ($9.30) with three of a kind, Kings



PokerStars Game #6809507746:  Hold'em Limit ($0.50/$1.00) - 2006/10/28 - 23:22:05 (ET)
Table 'Tanina' 10-max Seat #1 is the button
Seat 1: JMAC60 ($41 in chips) 
Seat 2: Redman102 ($13.60 in chips) 
Seat 4: Scylla ($7.65 in chips) 
Seat 5: Turkey1001 ($27.60 in chips) 
Seat 6: OCbarrister ($10.20 in chips) 
Seat 7: Moooose ($26.05 in chips) 
Seat 8: 1,1,2,3,5 ($33.45 in chips) 
Seat 9: AOSD ($8.45 in chips) 
Seat 10: 1nyyfan ($38.25 in chips) 
Redman102: posts small blind $0.25
wpcrso: is sitting out 
Scylla: posts big blind $0.50
*** HOLE CARDS ***
Dealt to 1,1,2,3,5 [9d Kd]
Turkey1001: calls $0.50
OCbarrister: calls $0.50
Moooose: calls $0.50
1,1,2,3,5: folds 
AOSD: folds 
1nyyfan: folds 
JMAC60: folds 
wpcrso leaves the table
Redman102 said, "ok didn't see it right...tu"
Redman102: folds 
Scylla: raises $0.50 to $1
Moooose said, "yw"
Turkey1001: calls $0.50
OCbarrister: calls $0.50
Moooose: calls $0.50
*** FLOP *** [4s Tc 4h]
Scylla: bets $0.50
Moooose said, "that was  a long time ago"
krofty joins the table at seat #3 
Turkey1001: folds 
OCbarrister: calls $0.50
Moooose: calls $0.50
*** TURN *** [4s Tc 4h] [7d]
Scylla: bets $1
OCbarrister: calls $1
Moooose: folds 
*** RIVER *** [4s Tc 4h 7d] [Js]
Scylla: bets $1
OCbarrister: folds 
Scylla collected $7.40 from pot
Scylla: doesn't show hand 
*** SUMMARY ***
Total pot $7.75 | Rake $0.35 
Board [4s Tc 4h 7d Js]
Seat 1: JMAC60 (button) folded before Flop (didn't bet)
Seat 2: Redman102 (small blind) folded before Flop
Seat 4: Scylla (big blind) collected ($7.40)
Seat 5: Turkey1001 folded on the Flop
Seat 6: OCbarrister folded on the River
Seat 7: Moooose folded on the Turn
Seat 8: 1,1,2,3,5 folded before Flop (didn't bet)
Seat 9: AOSD folded before Flop (didn't bet)
Seat 10: 1nyyfan folded before Flop (didn't bet)



PokerStars Game #6809521366:  Hold'em Limit ($0.50/$1.00) - 2006/10/28 - 23:23:10 (ET)
Table 'Tanina' 10-max Seat #2 is the button
Seat 1: JMAC60 ($41 in chips) 
Seat 2: Redman102 ($13.35 in chips) 
Seat 4: Scylla ($12.55 in chips) 
Seat 5: Turkey1001 ($26.60 in chips) 
Seat 6: OCbarrister ($7.70 in chips) 
Seat 7: Moooose ($24.55 in chips) 
Seat 8: 1,1,2,3,5 ($33.45 in chips) 
Seat 9: AOSD ($8.45 in chips) 
Seat 10: 1nyyfan ($38.25 in chips) 
krofty will be allowed to play after the button
Scylla: posts small blind $0.25
Turkey1001: posts big blind $0.50
*** HOLE CARDS ***
Dealt to 1,1,2,3,5 [Kh 4h]
Redman102 said, "I know was still worried about it"
OCbarrister: folds 
Moooose: folds 
1,1,2,3,5: folds 
AOSD: folds 
1nyyfan: folds 
JMAC60: folds 
OCbarrister leaves the table
Redman102 said, "but cleared it up for me"
Redman102: folds 
Scylla: raises $0.50 to $1
Turkey1001: calls $0.50
*** FLOP *** [8h 6c 7c]
Redman102 said, "thx again"
Scylla: bets $0.50
Turkey1001: calls $0.50
*** TURN *** [8h 6c 7c] [3d]
Scylla: bets $1
Turkey1001: calls $1
*** RIVER *** [8h 6c 7c 3d] [Th]
Scylla: bets $1
Turkey1001: calls $1
*** SHOW DOWN ***
Scylla: shows [Qc Tc] (a pair of Tens)
Turkey1001: mucks hand 
Scylla collected $6.70 from pot
*** SUMMARY ***
Total pot $7 | Rake $0.30 
Board [8h 6c 7c 3d Th]
Seat 1: JMAC60 folded before Flop (didn't bet)
Seat 2: Redman102 (button) folded before Flop (didn't bet)
Seat 4: Scylla (small blind) showed [Qc Tc] and won ($6.70) with a pair of Tens
Seat 5: Turkey1001 (big blind) mucked [As 6h]
Seat 6: OCbarrister folded before Flop (didn't bet)
Seat 7: Moooose folded before Flop (didn't bet)
Seat 8: 1,1,2,3,5 folded before Flop (didn't bet)
Seat 9: AOSD folded before Flop (didn't bet)
Seat 10: 1nyyfan folded before Flop (didn't bet)



PokerStars Game #6809531641:  Hold'em Limit ($0.50/$1.00) - 2006/10/28 - 23:24:00 (ET)
Table 'Tanina' 10-max Seat #4 is the button
Seat 1: JMAC60 ($41 in chips) 
Seat 2: Redman102 ($13.35 in chips) 
Seat 4: Scylla ($15.75 in chips) 
Seat 5: Turkey1001 ($23.10 in chips) 
Seat 7: Moooose ($24.55 in chips) 
Seat 8: 1,1,2,3,5 ($33.45 in chips) 
Seat 9: AOSD ($8.45 in chips) 
Seat 10: 1nyyfan ($38.25 in chips) 
Turkey1001: posts small blind $0.25
Moooose: posts big blind $0.50
krofty: sits out 
*** HOLE CARDS ***
Dealt to 1,1,2,3,5 [Ac 5d]
1,1,2,3,5: folds 
AOSD: calls $0.50
1nyyfan: folds 
JMAC60: folds 
Redman102: folds 
Scylla: folds 
Turkey1001: folds 
Moooose said, "no problem"
Moooose said, "yw"
Moooose: checks 
*** FLOP *** [7s 3h 4d]
SwaggerCanon joins the table at seat #6 
Moooose: checks 
AOSD: checks 
*** TURN *** [7s 3h 4d] [Td]
Moooose: checks 
AOSD: bets $1
Moooose: raises $1 to $2
AOSD: folds 
Moooose collected $3.10 from pot
Moooose: doesn't show hand 
*** SUMMARY ***
Total pot $3.25 | Rake $0.15 
Board [7s 3h 4d Td]
Seat 1: JMAC60 folded before Flop (didn't bet)
Seat 2: Redman102 folded before Flop (didn't bet)
Seat 4: Scylla (button) folded before Flop (didn't bet)
Seat 5: Turkey1001 (small blind) folded before Flop
Seat 7: Moooose (big blind) collected ($3.10)
Seat 8: 1,1,2,3,5 folded before Flop (didn't bet)
Seat 9: AOSD folded on the Turn
Seat 10: 1nyyfan folded before Flop (didn't bet)



PokerStars Game #6809541818:  Hold'em Limit ($0.50/$1.00) - 2006/10/28 - 23:24:49 (ET)
Table 'Tanina' 10-max Seat #5 is the button
Seat 1: JMAC60 ($41 in chips) 
Seat 2: Redman102 ($13.35 in chips) 
Seat 4: Scylla ($15.75 in chips) 
Seat 5: Turkey1001 ($22.85 in chips) 
Seat 7: Moooose ($26.15 in chips) 
Seat 8: 1,1,2,3,5 ($33.45 in chips) 
Seat 9: AOSD ($6.95 in chips) 
Seat 10: 1nyyfan ($38.25 in chips) 
SwaggerCanon will be allowed to play after the button
Moooose: posts small blind $0.25
1,1,2,3,5: posts big blind $0.50
krofty: sits out 
*** HOLE CARDS ***
Dealt to 1,1,2,3,5 [3h 7h]
AOSD: raises $0.50 to $1
1nyyfan: folds 
JMAC60: raises $0.50 to $1.50
Redman102: folds 
Scylla: folds 
Turkey1001: folds 
Moooose: calls $1.25
1,1,2,3,5: folds 
AOSD: raises $0.50 to $2
Betting is capped
JMAC60: calls $0.50
Moooose: calls $0.50
*** FLOP *** [7c Jd 6d]
Moooose: checks 
AOSD: bets $0.50
JMAC60: calls $0.50
Moooose: calls $0.50
*** TURN *** [7c Jd 6d] [4s]
Moooose: checks 
AOSD: bets $1
JMAC60: folds 
Moooose: calls $1
*** RIVER *** [7c Jd 6d 4s] [2h]
Moooose: checks 
AOSD: checks 
*** SHOW DOWN ***
Moooose: shows [8c 8d] (a pair of Eights)
AOSD: mucks hand 
Moooose collected $9.55 from pot
*** SUMMARY ***
Total pot $10 | Rake $0.45 
Board [7c Jd 6d 4s 2h]
Seat 1: JMAC60 folded on the Turn
Seat 2: Redman102 folded before Flop (didn't bet)
Seat 4: Scylla folded before Flop (didn't bet)
Seat 5: Turkey1001 (button) folded before Flop (didn't bet)
Seat 7: Moooose (small blind) showed [8c 8d] and won ($9.55) with a pair of Eights
Seat 8: 1,1,2,3,5 (big blind) folded before Flop
Seat 9: AOSD mucked [4h Th]
Seat 10: 1nyyfan folded before Flop (didn't bet)



PokerStars Game #6809552339:  Hold'em Limit ($0.50/$1.00) - 2006/10/28 - 23:25:39 (ET)
Table 'Tanina' 10-max Seat #7 is the button
Seat 1: JMAC60 ($38.50 in chips) 
Seat 2: Redman102 ($13.35 in chips) 
Seat 4: Scylla ($15.75 in chips) 
Seat 5: Turkey1001 ($22.85 in chips) 
Seat 7: Moooose ($32.20 in chips) 
Seat 8: 1,1,2,3,5 ($32.95 in chips) 
Seat 9: AOSD ($3.45 in chips) 
Seat 10: 1nyyfan ($38.25 in chips) 
1,1,2,3,5: posts small blind $0.25
AOSD: posts big blind $0.50
krofty: sits out 
SwaggerCanon: sits out 
*** HOLE CARDS ***
Dealt to 1,1,2,3,5 [Th Ac]
1nyyfan: calls $0.50
JMAC60: folds 
Redman102: folds 
Scylla: folds 
Turkey1001: calls $0.50
Moooose: calls $0.50
1,1,2,3,5: calls $0.25
AOSD: raises $0.50 to $1
1nyyfan: calls $0.50
Turkey1001: calls $0.50
Moooose: calls $0.50
1,1,2,3,5: calls $0.50
*** FLOP *** [6c 9h 3c]
1,1,2,3,5: checks 
AOSD: checks 
1nyyfan: checks 
Turkey1001: checks 
Moooose: bets $0.50
1,1,2,3,5: folds 
AOSD: folds 
1nyyfan: folds 
Turkey1001: folds 
Moooose collected $4.75 from pot
Moooose: doesn't show hand 
*** SUMMARY ***
Total pot $5 | Rake $0.25 
Board [6c 9h 3c]
Seat 1: JMAC60 folded before Flop (didn't bet)
Seat 2: Redman102 folded before Flop (didn't bet)
Seat 4: Scylla folded before Flop (didn't bet)
Seat 5: Turkey1001 folded on the Flop
Seat 7: Moooose (button) collected ($4.75)
Seat 8: 1,1,2,3,5 (small blind) folded on the Flop
Seat 9: AOSD (big blind) folded on the Flop
Seat 10: 1nyyfan folded on the Flop



PokerStars Game #6809563439:  Hold'em Limit ($0.50/$1.00) - 2006/10/28 - 23:26:32 (ET)
Table 'Tanina' 10-max Seat #8 is the button
Seat 1: JMAC60 ($38.50 in chips) 
Seat 2: Redman102 ($13.35 in chips) 
Seat 4: Scylla ($15.75 in chips) 
Seat 5: Turkey1001 ($21.85 in chips) 
Seat 7: Moooose ($35.95 in chips) 
Seat 8: 1,1,2,3,5 ($31.95 in chips) 
Seat 9: AOSD ($2.45 in chips) 
Seat 10: 1nyyfan ($37.25 in chips) 
AOSD: posts small blind $0.25
1nyyfan: posts big blind $0.50
krofty: sits out 
SwaggerCanon: sits out 
*** HOLE CARDS ***
Dealt to 1,1,2,3,5 [Jh 7d]
JMAC60: folds 
Redman102: folds 
Scylla: folds 
Turkey1001: folds 
Moooose: folds 
1,1,2,3,5: folds 
AOSD: calls $0.25
1nyyfan: checks 
*** FLOP *** [4s Td Ah]
AOSD: checks 
1nyyfan: checks 
*** TURN *** [4s Td Ah] [8h]
AOSD: bets $1
1nyyfan: calls $1
*** RIVER *** [4s Td Ah 8h] [7s]
AOSD: bets $0.95 and is all-in
1nyyfan: calls $0.95
*** SHOW DOWN ***
AOSD: shows [2c Jc] (high card Ace)
1nyyfan: shows [Tc Kh] (a pair of Tens)
1nyyfan collected $4.70 from pot
*** SUMMARY ***
Total pot $4.90 | Rake $0.20 
Board [4s Td Ah 8h 7s]
Seat 1: JMAC60 folded before Flop (didn't bet)
Seat 2: Redman102 folded before Flop (didn't bet)
Seat 4: Scylla folded before Flop (didn't bet)
Seat 5: Turkey1001 folded before Flop (didn't bet)
Seat 7: Moooose folded before Flop (didn't bet)
Seat 8: 1,1,2,3,5 (button) folded before Flop (didn't bet)
Seat 9: AOSD (small blind) showed [2c Jc] and lost with high card Ace
Seat 10: 1nyyfan (big blind) showed [Tc Kh] and won ($4.70) with a pair of Tens



PokerStars Game #6809569715:  Hold'em Limit ($0.50/$1.00) - 2006/10/28 - 23:27:02 (ET)
Table 'Tanina' 10-max Seat #10 is the button
Seat 1: JMAC60 ($38.50 in chips) 
Seat 2: Redman102 ($13.35 in chips) 
Seat 4: Scylla ($15.75 in chips) 
Seat 5: Turkey1001 ($21.85 in chips) 
Seat 7: Moooose ($35.95 in chips) 
Seat 8: 1,1,2,3,5 ($31.95 in chips) 
Seat 10: 1nyyfan ($39.50 in chips) 
AOSD leaves the table
JMAC60: posts small blind $0.25
Redman102: posts big blind $0.50
krofty: sits out 
SwaggerCanon: sits out 
*** HOLE CARDS ***
Dealt to 1,1,2,3,5 [Qc Kc]
Scylla: folds 
Turkey1001: calls $0.50
Moooose: folds 
1,1,2,3,5: raises $0.50 to $1
1nyyfan: folds 
JMAC60: calls $0.75
Lawdog42 joins the table at seat #9 
Redman102: calls $0.50
Turkey1001: calls $0.50
*** FLOP *** [Td 9c 6h]
JMAC60: checks 
Redman102: checks 
Turkey1001: checks 
1,1,2,3,5: checks 
*** TURN *** [Td 9c 6h] [5s]
JMAC60: checks 
Redman102: checks 
Turkey1001: checks 
1,1,2,3,5: checks 
*** RIVER *** [Td 9c 6h 5s] [2d]
JMAC60: checks 
Redman102: checks 
Turkey1001: checks 
1,1,2,3,5: checks 
*** SHOW DOWN ***
JMAC60: shows [Jh Ks] (high card King)
Redman102: shows [5d 4c] (a pair of Fives)
Turkey1001: mucks hand 
1,1,2,3,5: mucks hand 
Redman102 collected $3.80 from pot
*** SUMMARY ***
Total pot $4 | Rake $0.20 
Board [Td 9c 6h 5s 2d]
Seat 1: JMAC60 (small blind) showed [Jh Ks] and lost with high card King
Seat 2: Redman102 (big blind) showed [5d 4c] and won ($3.80) with a pair of Fives
Seat 4: Scylla folded before Flop (didn't bet)
Seat 5: Turkey1001 mucked [3c Ac]
Seat 7: Moooose folded before Flop (didn't bet)
Seat 8: 1,1,2,3,5 mucked [Qc Kc]
Seat 10: 1nyyfan (button) folded before Flop (didn't bet)



PokerStars Game #6809585687:  Hold'em Limit ($0.50/$1.00) - 2006/10/28 - 23:28:19 (ET)
Table 'Tanina' 10-max Seat #1 is the button
Seat 1: JMAC60 ($37.50 in chips) 
Seat 2: Redman102 ($16.15 in chips) 
Seat 3: krofty ($7 in chips) 
Seat 4: Scylla ($15.75 in chips) 
Seat 5: Turkey1001 ($20.85 in chips) 
Seat 7: Moooose ($35.95 in chips) 
Seat 8: 1,1,2,3,5 ($30.95 in chips) 
Seat 9: Lawdog42 ($20 in chips) 
Seat 10: 1nyyfan ($39.50 in chips) 
Redman102: posts small blind $0.25
krofty: posts big blind $0.50
SwaggerCanon: sits out 
Lawdog42: posts big blind $0.50
*** HOLE CARDS ***
Dealt to 1,1,2,3,5 [4d 2d]
Scylla: calls $0.50
Turkey1001: folds 
Moooose: folds 
1,1,2,3,5: folds 
Lawdog42: checks 
1nyyfan: folds 
JMAC60: folds 
Redman102: calls $0.25
krofty: checks 
*** FLOP *** [9s Ad Td]
Redman102: bets $0.50
krofty: calls $0.50
Scylla: folds 
Lawdog42: folds 
*** TURN *** [9s Ad Td] [Jh]
Redman102: checks 
krofty: checks 
*** RIVER *** [9s Ad Td Jh] [Th]
Redman102: bets $1
krofty: calls $1
*** SHOW DOWN ***
Redman102: shows [3c Tc] (three of a kind, Tens)
krofty: mucks hand 
Redman102 collected $4.80 from pot
*** SUMMARY ***
Total pot $5 | Rake $0.20 
Board [9s Ad Td Jh Th]
Seat 1: JMAC60 (button) folded before Flop (didn't bet)
Seat 2: Redman102 (small blind) showed [3c Tc] and won ($4.80) with three of a kind, Tens
Seat 3: krofty (big blind) mucked [9d Ks]
Seat 4: Scylla folded on the Flop
Seat 5: Turkey1001 folded before Flop (didn't bet)
Seat 7: Moooose folded before Flop (didn't bet)
Seat 8: 1,1,2,3,5 folded before Flop (didn't bet)
Seat 9: Lawdog42 folded on the Flop
Seat 10: 1nyyfan folded before Flop (didn't bet)



PokerStars Game #6809597625:  Hold'em Limit ($0.50/$1.00) - 2006/10/28 - 23:29:16 (ET)
Table 'Tanina' 10-max Seat #2 is the button
Seat 1: JMAC60 ($37.50 in chips) 
Seat 2: Redman102 ($18.95 in chips) 
Seat 3: krofty ($5 in chips) 
Seat 4: Scylla ($15.25 in chips) 
Seat 5: Turkey1001 ($20.85 in chips) 
Seat 7: Moooose ($35.95 in chips) 
Seat 8: 1,1,2,3,5 ($30.95 in chips) 
Seat 9: Lawdog42 ($19.50 in chips) 
Seat 10: 1nyyfan ($39.50 in chips) 
krofty: posts small blind $0.25
Scylla: posts big blind $0.50
SwaggerCanon: sits out 
*** HOLE CARDS ***
Dealt to 1,1,2,3,5 [8d Tc]
Turkey1001: folds 
Moooose: folds 
1,1,2,3,5: folds 
Lawdog42: folds 
1nyyfan: calls $0.50
JMAC60: folds 
Redman102: folds 
krofty: raises $0.50 to $1
Scylla: folds 
1nyyfan: calls $0.50
*** FLOP *** [Kd 6s 7c]
krofty: bets $0.50
1nyyfan: folds 
krofty collected $2.40 from pot
krofty: doesn't show hand 
*** SUMMARY ***
Total pot $2.50 | Rake $0.10 
Board [Kd 6s 7c]
Seat 1: JMAC60 folded before Flop (didn't bet)
Seat 2: Redman102 (button) folded before Flop (didn't bet)
Seat 3: krofty (small blind) collected ($2.40)
Seat 4: Scylla (big blind) folded before Flop
Seat 5: Turkey1001 folded before Flop (didn't bet)
Seat 7: Moooose folded before Flop (didn't bet)
Seat 8: 1,1,2,3,5 folded before Flop (didn't bet)
Seat 9: Lawdog42 folded before Flop (didn't bet)
Seat 10: 1nyyfan folded on the Flop



PokerStars Game #6809603313:  Hold'em Limit ($0.50/$1.00) - 2006/10/28 - 23:29:43 (ET)
Table 'Tanina' 10-max Seat #3 is the button
Seat 1: JMAC60 ($37.50 in chips) 
Seat 2: Redman102 ($18.95 in chips) 
Seat 3: krofty ($6.40 in chips) 
Seat 4: Scylla ($14.75 in chips) 
Seat 5: Turkey1001 ($20.85 in chips) 
Seat 7: Moooose ($35.95 in chips) 
Seat 8: 1,1,2,3,5 ($30.95 in chips) 
Seat 9: Lawdog42 ($19.50 in chips) 
Seat 10: 1nyyfan ($38.50 in chips) 
Scylla: posts small blind $0.25
Turkey1001: posts big blind $0.50
SwaggerCanon: sits out 
*** HOLE CARDS ***
Dealt to 1,1,2,3,5 [5h 6c]
Moooose: folds 
1,1,2,3,5: folds 
Lawdog42: folds 
1nyyfan: folds 
JMAC60: folds 
Redman102: folds 
krofty: raises $0.50 to $1
Scylla: calls $0.75
Turkey1001: raises $0.50 to $1.50
krofty: calls $0.50
Scylla: calls $0.50
*** FLOP *** [4h 5c 5d]
Scylla: checks 
Turkey1001: bets $0.50
krofty: folds 
Scylla: calls $0.50
*** TURN *** [4h 5c 5d] [Jd]
Scylla: checks 
Turkey1001: bets $1
Scylla: calls $1
*** RIVER *** [4h 5c 5d Jd] [7c]
Scylla: checks 
Turkey1001: bets $1
Scylla: calls $1
*** SHOW DOWN ***
Turkey1001: shows [Ah Kc] (a pair of Fives)
Scylla: mucks hand 
Turkey1001 collected $9.05 from pot
*** SUMMARY ***
Total pot $9.50 | Rake $0.45 
Board [4h 5c 5d Jd 7c]
Seat 1: JMAC60 folded before Flop (didn't bet)
Seat 2: Redman102 folded before Flop (didn't bet)
Seat 3: krofty (button) folded on the Flop
Seat 4: Scylla (small blind) mucked [6d Ad]
Seat 5: Turkey1001 (big blind) showed [Ah Kc] and won ($9.05) with a pair of Fives
Seat 7: Moooose folded before Flop (didn't bet)
Seat 8: 1,1,2,3,5 folded before Flop (didn't bet)
Seat 9: Lawdog42 folded before Flop (didn't bet)
Seat 10: 1nyyfan folded before Flop (didn't bet)



PokerStars Game #6809618669:  Hold'em Limit ($0.50/$1.00) - 2006/10/28 - 23:30:48 (ET)
Table 'Tanina' 10-max Seat #4 is the button
Seat 1: JMAC60 ($37.50 in chips) 
Seat 2: Redman102 ($18.95 in chips) 
Seat 3: krofty ($4.90 in chips) 
Seat 4: Scylla ($10.75 in chips) 
Seat 5: Turkey1001 ($25.90 in chips) 
Seat 6: SwaggerCanon ($20 in chips) 
Seat 7: Moooose ($35.95 in chips) 
Seat 8: 1,1,2,3,5 ($30.95 in chips) 
Seat 9: Lawdog42 ($19.50 in chips) 
Seat 10: 1nyyfan ($38.50 in chips) 
Turkey1001: posts small blind $0.25
SwaggerCanon: posts big blind $0.50
*** HOLE CARDS ***
Dealt to 1,1,2,3,5 [8c As]
Moooose: folds 
1,1,2,3,5: folds 
Lawdog42: calls $0.50
1nyyfan: calls $0.50
JMAC60: folds 
Redman102: calls $0.50
krofty: folds 
Scylla: folds 
Turkey1001: calls $0.25
SwaggerCanon: checks 
*** FLOP *** [3d 5c Js]
Turkey1001: checks 
SwaggerCanon: checks 
Lawdog42: bets $0.50
1nyyfan: calls $0.50
Redman102: raises $0.50 to $1
Turkey1001: folds 
SwaggerCanon: folds 
Lawdog42: calls $0.50
1nyyfan: calls $0.50
*** TURN *** [3d 5c Js] [9s]
Lawdog42: checks 
1nyyfan: checks 
Redman102: bets $1
Lawdog42: folds 
1nyyfan: folds 
Redman102 collected $5.25 from pot
*** SUMMARY ***
Total pot $5.50 | Rake $0.25 
Board [3d 5c Js 9s]
Seat 1: JMAC60 folded before Flop (didn't bet)
Seat 2: Redman102 collected ($5.25)
Seat 3: krofty folded before Flop (didn't bet)
Seat 4: Scylla (button) folded before Flop (didn't bet)
Seat 5: Turkey1001 (small blind) folded on the Flop
Seat 6: SwaggerCanon (big blind) folded on the Flop
Seat 7: Moooose folded before Flop (didn't bet)
Seat 8: 1,1,2,3,5 folded before Flop (didn't bet)
Seat 9: Lawdog42 folded on the Turn
Seat 10: 1nyyfan folded on the Turn



PokerStars Game #6809635290:  Hold'em Limit ($0.50/$1.00) - 2006/10/28 - 23:32:01 (ET)
Table 'Tanina' 10-max Seat #5 is the button
Seat 1: JMAC60 ($37.50 in chips) 
Seat 2: Redman102 ($22.70 in chips) 
Seat 3: krofty ($4.90 in chips) 
Seat 4: Scylla ($10.75 in chips) 
Seat 5: Turkey1001 ($25.40 in chips) 
Seat 6: SwaggerCanon ($19.50 in chips) 
Seat 7: Moooose ($35.95 in chips) 
Seat 8: 1,1,2,3,5 ($30.95 in chips) 
Seat 9: Lawdog42 ($18 in chips) 
Seat 10: 1nyyfan ($37 in chips) 
SwaggerCanon: posts small blind $0.25
Moooose: posts big blind $0.50
*** HOLE CARDS ***
Dealt to 1,1,2,3,5 [4d 9d]
1,1,2,3,5: folds 
1,1,2,3,5 is sitting out
Lawdog42: folds 
1nyyfan: calls $0.50
JMAC60: folds 
Redman102: folds 
krofty: folds 
Scylla: calls $0.50
Turkey1001: folds 
SwaggerCanon: folds 
Moooose: checks 
*** FLOP *** [4h Js 7c]
Moooose: checks 
1nyyfan: checks 
Scylla: bets $0.50
Moooose: folds 
1nyyfan: folds 
Scylla collected $1.70 from pot
Scylla: doesn't show hand 
*** SUMMARY ***
Total pot $1.75 | Rake $0.05 
Board [4h Js 7c]
Seat 1: JMAC60 folded before Flop (didn't bet)
Seat 2: Redman102 folded before Flop (didn't bet)
Seat 3: krofty folded before Flop (didn't bet)
Seat 4: Scylla collected ($1.70)
Seat 5: Turkey1001 (button) folded before Flop (didn't bet)
Seat 6: SwaggerCanon (small blind) folded before Flop
Seat 7: Moooose (big blind) folded on the Flop
Seat 8: 1,1,2,3,5 folded before Flop (didn't bet)
Seat 9: Lawdog42 folded before Flop (didn't bet)
Seat 10: 1nyyfan folded on the Flop



PokerStars Game #6809800232:  Hold'em Limit ($0.50/$1.00) - 2006/10/28 - 23:44:25 (ET)
Table 'Tanina' 10-max Seat #3 is the button
Seat 1: JMAC60 ($41.45 in chips) 
Seat 2: BBmack ($18.75 in chips) 
Seat 3: krofty ($3.75 in chips) 
Seat 4: Scylla ($16.10 in chips) 
Seat 6: SwaggerCanon ($29.40 in chips) 
Seat 7: Moooose ($36.50 in chips) 
Seat 8: 1,1,2,3,5 ($30.95 in chips) 
Seat 9: Lawdog42 ($13.60 in chips) 
Seat 10: 1nyyfan ($29.25 in chips) 
Scylla: posts small blind $0.25
SwaggerCanon: posts big blind $0.50
1,1,2,3,5: posts small & big blinds $0.75
*** HOLE CARDS ***
Dealt to 1,1,2,3,5 [4c 7d]
Moooose: calls $0.50
1,1,2,3,5: checks 
Lawdog42: folds 
1nyyfan: folds 
JMAC60: folds 
BBmack: folds 
krofty: folds 
Scylla: calls $0.25
SwaggerCanon: checks 
*** FLOP *** [7s Qh 4s]
Scylla: checks 
SwaggerCanon: checks 
Moooose: bets $0.50
1,1,2,3,5: raises $0.50 to $1
Scylla: folds 
SwaggerCanon: folds 
Moooose: folds 
1,1,2,3,5 collected $3.10 from pot
1,1,2,3,5: doesn't show hand 
*** SUMMARY ***
Total pot $3.25 | Rake $0.15 
Board [7s Qh 4s]
Seat 1: JMAC60 folded before Flop (didn't bet)
Seat 2: BBmack folded before Flop (didn't bet)
Seat 3: krofty (button) folded before Flop (didn't bet)
Seat 4: Scylla (small blind) folded on the Flop
Seat 6: SwaggerCanon (big blind) folded on the Flop
Seat 7: Moooose folded on the Flop
Seat 8: 1,1,2,3,5 collected ($3.10)
Seat 9: Lawdog42 folded before Flop (didn't bet)
Seat 10: 1nyyfan folded before Flop (didn't bet)



PokerStars Game #6809807714:  Hold'em Limit ($0.50/$1.00) - 2006/10/28 - 23:44:59 (ET)
Table 'Tanina' 10-max Seat #4 is the button
Seat 1: JMAC60 ($41.45 in chips) 
Seat 2: BBmack ($18.75 in chips) 
Seat 3: krofty ($3.75 in chips) 
Seat 4: Scylla ($15.60 in chips) 
Seat 6: SwaggerCanon ($28.90 in chips) 
Seat 7: Moooose ($35.50 in chips) 
Seat 8: 1,1,2,3,5 ($32.80 in chips) 
Seat 9: Lawdog42 ($13.60 in chips) 
Seat 10: 1nyyfan ($29.25 in chips) 
SwaggerCanon: posts small blind $0.25
Moooose: posts big blind $0.50
*** HOLE CARDS ***
Dealt to 1,1,2,3,5 [Kc Th]
1,1,2,3,5: folds 
Lawdog42: raises $0.50 to $1
1nyyfan: calls $1
JMAC60: folds 
BBmack: folds 
krofty: folds 
Scylla: calls $1
SwaggerCanon: folds 
Moooose: calls $0.50
*** FLOP *** [Ks 4c 5c]
Moooose: checks 
Lawdog42: bets $0.50
1nyyfan: calls $0.50
Scylla: folds 
Moooose: calls $0.50
*** TURN *** [Ks 4c 5c] [8h]
Moooose: checks 
Lawdog42: bets $1
1nyyfan: folds 
budgirl49 joins the table at seat #5 
Moooose: calls $1
*** RIVER *** [Ks 4c 5c 8h] [3d]
Moooose: checks 
Lawdog42: bets $1
Moooose: calls $1
*** SHOW DOWN ***
Lawdog42: shows [As 7s] (high card Ace)
Moooose: shows [Qc 4h] (a pair of Fours)
Moooose collected $9.30 from pot
*** SUMMARY ***
Total pot $9.75 | Rake $0.45 
Board [Ks 4c 5c 8h 3d]
Seat 1: JMAC60 folded before Flop (didn't bet)
Seat 2: BBmack folded before Flop (didn't bet)
Seat 3: krofty folded before Flop (didn't bet)
Seat 4: Scylla (button) folded on the Flop
Seat 6: SwaggerCanon (small blind) folded before Flop
Seat 7: Moooose (big blind) showed [Qc 4h] and won ($9.30) with a pair of Fours
Seat 8: 1,1,2,3,5 folded before Flop (didn't bet)
Seat 9: Lawdog42 showed [As 7s] and lost with high card Ace
Seat 10: 1nyyfan folded on the Turn



PokerStars Game #6809821376:  Hold'em Limit ($0.50/$1.00) - 2006/10/28 - 23:46:01 (ET)
Table 'Tanina' 10-max Seat #6 is the button
Seat 1: JMAC60 ($41.45 in chips) 
Seat 2: BBmack ($18.75 in chips) 
Seat 3: krofty ($3.75 in chips) 
Seat 4: Scylla ($14.60 in chips) 
Seat 6: SwaggerCanon ($28.65 in chips) 
Seat 7: Moooose ($41.30 in chips) 
Seat 8: 1,1,2,3,5 ($32.80 in chips) 
Seat 9: Lawdog42 ($10.10 in chips) 
Seat 10: 1nyyfan ($27.75 in chips) 
Moooose: posts small blind $0.25
1,1,2,3,5: posts big blind $0.50
budgirl49: sits out 
*** HOLE CARDS ***
Dealt to 1,1,2,3,5 [2d 8d]
Lawdog42: folds 
1nyyfan: folds 
Lawdog42 leaves the table
JMAC60: calls $0.50
BBmack: calls $0.50
krofty: folds 
Scylla: calls $0.50
SwaggerCanon: raises $0.50 to $1
Moooose: folds 
1,1,2,3,5: folds 
JMAC60: calls $0.50
BBmack: calls $0.50
Scylla: calls $0.50
*** FLOP *** [Jd 3c 2s]
JMAC60: checks 
BBmack: checks 
Scylla: checks 
SwaggerCanon: bets $0.50
JMAC60: calls $0.50
BBmack: calls $0.50
Scylla: calls $0.50
*** TURN *** [Jd 3c 2s] [Qc]
JMAC60: checks 
BBmack: checks 
Scylla: checks 
SwaggerCanon: bets $1
JMAC60: folds 
BBmack: calls $1
Scylla: folds 
*** RIVER *** [Jd 3c 2s Qc] [Ah]
BBmack: checks 
SwaggerCanon: bets $1
BBmack: folds 
SwaggerCanon collected $8.35 from pot
*** SUMMARY ***
Total pot $8.75 | Rake $0.40 
Board [Jd 3c 2s Qc Ah]
Seat 1: JMAC60 folded on the Turn
Seat 2: BBmack folded on the River
Seat 3: krofty folded before Flop (didn't bet)
Seat 4: Scylla folded on the Turn
Seat 6: SwaggerCanon (button) collected ($8.35)
Seat 7: Moooose (small blind) folded before Flop
Seat 8: 1,1,2,3,5 (big blind) folded before Flop
Seat 9: Lawdog42 folded before Flop (didn't bet)
Seat 10: 1nyyfan folded before Flop (didn't bet)



PokerStars Game #6809838346:  Hold'em Limit ($0.50/$1.00) - 2006/10/28 - 23:47:20 (ET)
Table 'Tanina' 10-max Seat #7 is the button
Seat 1: JMAC60 ($39.95 in chips) 
Seat 2: BBmack ($16.25 in chips) 
Seat 3: krofty ($6.75 in chips) 
Seat 4: Scylla ($13.10 in chips) 
Seat 5: budgirl49 ($20 in chips) 
Seat 6: SwaggerCanon ($34.50 in chips) 
Seat 7: Moooose ($41.05 in chips) 
Seat 8: 1,1,2,3,5 ($32.30 in chips) 
Seat 10: 1nyyfan ($27.75 in chips) 
1,1,2,3,5: posts small blind $0.25
1nyyfan: posts big blind $0.50
budgirl49: posts big blind $0.50
*** HOLE CARDS ***
Dealt to 1,1,2,3,5 [6h 9d]
JMAC60: folds 
BBmack: folds 
krofty: folds 
Scylla: raises $0.50 to $1
budgirl49: calls $0.50
SwaggerCanon: folds 
Moooose: folds 
1,1,2,3,5: folds 
1nyyfan: calls $0.50
*** FLOP *** [3s Jh 5d]
1nyyfan: checks 
Scylla: bets $0.50
budgirl49: calls $0.50
1nyyfan: folds 
*** TURN *** [3s Jh 5d] [6c]
Scylla: bets $1
budgirl49: calls $1
*** RIVER *** [3s Jh 5d 6c] [As]
Scylla: bets $1
budgirl49: raises $1 to $2
Scylla: raises $1 to $3
budgirl49: raises $1 to $4
Betting is capped
Scylla: calls $1
*** SHOW DOWN ***
budgirl49: shows [Ah 6s] (two pair, Aces and Sixes)
Scylla: mucks hand 
budgirl49 collected $13.75 from pot
*** SUMMARY ***
Total pot $14.25 | Rake $0.50 
Board [3s Jh 5d 6c As]
Seat 1: JMAC60 folded before Flop (didn't bet)
Seat 2: BBmack folded before Flop (didn't bet)
Seat 3: krofty folded before Flop (didn't bet)
Seat 4: Scylla mucked [Ac Kd]
Seat 5: budgirl49 showed [Ah 6s] and won ($13.75) with two pair, Aces and Sixes
Seat 6: SwaggerCanon folded before Flop (didn't bet)
Seat 7: Moooose (button) folded before Flop (didn't bet)
Seat 8: 1,1,2,3,5 (small blind) folded before Flop
Seat 10: 1nyyfan (big blind) folded on the Flop



PokerStars Game #6809846645:  Hold'em Limit ($0.50/$1.00) - 2006/10/28 - 23:47:58 (ET)
Table 'Tanina' 10-max Seat #8 is the button
Seat 1: JMAC60 ($39.95 in chips) 
Seat 2: BBmack ($16.25 in chips) 
Seat 3: krofty ($6.75 in chips) 
Seat 4: Scylla ($6.60 in chips) 
Seat 5: budgirl49 ($27.25 in chips) 
Seat 6: SwaggerCanon ($34.50 in chips) 
Seat 7: Moooose ($41.05 in chips) 
Seat 8: 1,1,2,3,5 ($32.05 in chips) 
Seat 10: 1nyyfan ($26.75 in chips) 
1nyyfan: posts small blind $0.25
JMAC60: posts big blind $0.50
*** HOLE CARDS ***
Dealt to 1,1,2,3,5 [6d 3c]
BBmack: calls $0.50
Scylla said, "nh"
krofty: folds 
Scylla: folds 
budgirl49: folds 
SwaggerCanon: folds 
Moooose: folds 
1,1,2,3,5: folds 
1nyyfan: calls $0.25
budgirl49 said, "ty'"
JMAC60: checks 
*** FLOP *** [Ac Jc Jd]
1nyyfan: checks 
JMAC60: bets $0.50
BBmack: folds 
1nyyfan: folds 
JMAC60 collected $1.45 from pot
JMAC60: doesn't show hand 
*** SUMMARY ***
Total pot $1.50 | Rake $0.05 
Board [Ac Jc Jd]
Seat 1: JMAC60 (big blind) collected ($1.45)
Seat 2: BBmack folded on the Flop
Seat 3: krofty folded before Flop (didn't bet)
Seat 4: Scylla folded before Flop (didn't bet)
Seat 5: budgirl49 folded before Flop (didn't bet)
Seat 6: SwaggerCanon folded before Flop (didn't bet)
Seat 7: Moooose folded before Flop (didn't bet)
Seat 8: 1,1,2,3,5 (button) folded before Flop (didn't bet)
Seat 10: 1nyyfan (small blind) folded on the Flop



PokerStars Game #6809852509:  Hold'em Limit ($0.50/$1.00) - 2006/10/28 - 23:48:25 (ET)
Table 'Tanina' 10-max Seat #10 is the button
Seat 1: JMAC60 ($40.90 in chips) 
Seat 2: BBmack ($15.75 in chips) 
Seat 3: krofty ($6.75 in chips) 
Seat 4: Scylla ($6.60 in chips) 
Seat 5: budgirl49 ($27.25 in chips) 
Seat 6: SwaggerCanon ($34.50 in chips) 
Seat 7: Moooose ($41.05 in chips) 
Seat 8: 1,1,2,3,5 ($32.05 in chips) 
Seat 10: 1nyyfan ($26.25 in chips) 
JMAC60: posts small blind $0.25
BBmack: posts big blind $0.50
*** HOLE CARDS ***
Dealt to 1,1,2,3,5 [7h 2h]
krofty: folds 
Scylla: folds 
budgirl49: folds 
SwaggerCanon: folds 
Moooose: folds 
1,1,2,3,5: folds 
1nyyfan: calls $0.50
JMAC60: folds 
BBmack: checks 
*** FLOP *** [6d 4h Qs]
BBmack: checks 
1nyyfan: bets $0.50
BBmack: folds 
1nyyfan collected $1.20 from pot
*** SUMMARY ***
Total pot $1.25 | Rake $0.05 
Board [6d 4h Qs]
Seat 1: JMAC60 (small blind) folded before Flop
Seat 2: BBmack (big blind) folded on the Flop
Seat 3: krofty folded before Flop (didn't bet)
Seat 4: Scylla folded before Flop (didn't bet)
Seat 5: budgirl49 folded before Flop (didn't bet)
Seat 6: SwaggerCanon folded before Flop (didn't bet)
Seat 7: Moooose folded before Flop (didn't bet)
Seat 8: 1,1,2,3,5 folded before Flop (didn't bet)
Seat 10: 1nyyfan (button) collected ($1.20)



PokerStars Game #6809857097:  Hold'em Limit ($0.50/$1.00) - 2006/10/28 - 23:48:46 (ET)
Table 'Tanina' 10-max Seat #1 is the button
Seat 1: JMAC60 ($40.65 in chips) 
Seat 2: BBmack ($15.25 in chips) 
Seat 3: krofty ($6.75 in chips) 
Seat 4: Scylla ($6.60 in chips) 
Seat 5: budgirl49 ($27.25 in chips) 
Seat 6: SwaggerCanon ($34.50 in chips) 
Seat 7: Moooose ($41.05 in chips) 
Seat 8: 1,1,2,3,5 ($32.05 in chips) 
Seat 10: 1nyyfan ($26.95 in chips) 
BBmack: posts small blind $0.25
krofty: posts big blind $0.50
*** HOLE CARDS ***
Dealt to 1,1,2,3,5 [8s 2h]
Scylla: folds 
budgirl49: folds 
SwaggerCanon: folds 
Moooose: folds 
1,1,2,3,5: folds 
1nyyfan: folds 
JMAC60: folds 
BBmack: calls $0.25
krofty has timed out
krofty: folds 
krofty is sitting out
krofty has returned
BBmack collected $1 from pot
*** SUMMARY ***
Total pot $1 | Rake $0 
Seat 1: JMAC60 (button) folded before Flop (didn't bet)
Seat 2: BBmack (small blind) collected ($1)
Seat 3: krofty (big blind) folded before Flop
Seat 4: Scylla folded before Flop (didn't bet)
Seat 5: budgirl49 folded before Flop (didn't bet)
Seat 6: SwaggerCanon folded before Flop (didn't bet)
Seat 7: Moooose folded before Flop (didn't bet)
Seat 8: 1,1,2,3,5 folded before Flop (didn't bet)
Seat 10: 1nyyfan folded before Flop (didn't bet)



PokerStars Game #6809864139:  Hold'em Limit ($0.50/$1.00) - 2006/10/28 - 23:49:19 (ET)
Table 'Tanina' 10-max Seat #2 is the button
Seat 1: JMAC60 ($40.65 in chips) 
Seat 2: BBmack ($15.75 in chips) 
Seat 3: krofty ($6.25 in chips) 
Seat 4: Scylla ($6.60 in chips) 
Seat 5: budgirl49 ($27.25 in chips) 
Seat 6: SwaggerCanon ($34.50 in chips) 
Seat 7: Moooose ($41.05 in chips) 
Seat 8: 1,1,2,3,5 ($32.05 in chips) 
Seat 10: 1nyyfan ($26.95 in chips) 
krofty: posts small blind $0.25
Scylla: posts big blind $0.50
*** HOLE CARDS ***
Dealt to 1,1,2,3,5 [2s 2c]
budgirl49: calls $0.50
SwaggerCanon: raises $0.50 to $1
Moooose: folds 
1,1,2,3,5: folds 
1nyyfan: folds 
JMAC60: folds 
BBmack: folds 
krofty: folds 
Scylla: calls $0.50
budgirl49: calls $0.50
*** FLOP *** [9h 5c 6d]
Scylla: checks 
budgirl49: bets $0.50
SwaggerCanon: calls $0.50
Scylla: calls $0.50
*** TURN *** [9h 5c 6d] [Qc]
Scylla: checks 
budgirl49: bets $1
SwaggerCanon: raises $1 to $2
Scylla: calls $2
budgirl49: calls $1
*** RIVER *** [9h 5c 6d Qc] [Th]
Scylla: checks 
budgirl49: checks 
SwaggerCanon: bets $1
Scylla: raises $1 to $2
budgirl49: folds 
SwaggerCanon: calls $1
*** SHOW DOWN ***
Scylla: shows [9s Qd] (two pair, Queens and Nines)
SwaggerCanon: mucks hand 
Scylla collected $14.25 from pot
*** SUMMARY ***
Total pot $14.75 | Rake $0.50 
Board [9h 5c 6d Qc Th]
Seat 1: JMAC60 folded before Flop (didn't bet)
Seat 2: BBmack (button) folded before Flop (didn't bet)
Seat 3: krofty (small blind) folded before Flop
Seat 4: Scylla (big blind) showed [9s Qd] and won ($14.25) with two pair, Queens and Nines
Seat 5: budgirl49 folded on the River
Seat 6: SwaggerCanon mucked [Ac Qh]
Seat 7: Moooose folded before Flop (didn't bet)
Seat 8: 1,1,2,3,5 folded before Flop (didn't bet)
Seat 10: 1nyyfan folded before Flop (didn't bet)



PokerStars Game #6809875933:  Hold'em Limit ($0.50/$1.00) - 2006/10/28 - 23:50:13 (ET)
Table 'Tanina' 10-max Seat #3 is the button
Seat 1: JMAC60 ($40.65 in chips) 
Seat 2: BBmack ($15.75 in chips) 
Seat 3: krofty ($6 in chips) 
Seat 4: Scylla ($15.35 in chips) 
Seat 5: budgirl49 ($23.75 in chips) 
Seat 6: SwaggerCanon ($29 in chips) 
Seat 7: Moooose ($41.05 in chips) 
Seat 8: 1,1,2,3,5 ($32.05 in chips) 
Seat 10: 1nyyfan ($26.95 in chips) 
Scylla: posts small blind $0.25
budgirl49: posts big blind $0.50
*** HOLE CARDS ***
Dealt to 1,1,2,3,5 [5h 2c]
SwaggerCanon: folds 
Moooose: calls $0.50
1,1,2,3,5: folds 
1nyyfan: folds 
JMAC60: folds 
BBmack: folds 
budgirl49 said, "nh"
krofty: raises $0.50 to $1
Scylla: folds 
budgirl49: calls $0.50
Scylla said, "ty"
Moooose: calls $0.50
*** FLOP *** [Ad 7s Kd]
budgirl49: checks 
Moooose: checks 
krofty: bets $0.50
budgirl49: folds 
Moooose: folds 
krofty collected $3.10 from pot
krofty: doesn't show hand 
*** SUMMARY ***
Total pot $3.25 | Rake $0.15 
Board [Ad 7s Kd]
Seat 1: JMAC60 folded before Flop (didn't bet)
Seat 2: BBmack folded before Flop (didn't bet)
Seat 3: krofty (button) collected ($3.10)
Seat 4: Scylla (small blind) folded before Flop
Seat 5: budgirl49 (big blind) folded on the Flop
Seat 6: SwaggerCanon folded before Flop (didn't bet)
Seat 7: Moooose folded on the Flop
Seat 8: 1,1,2,3,5 folded before Flop (didn't bet)
Seat 10: 1nyyfan folded before Flop (didn't bet)



PokerStars Game #6809884862:  Hold'em Limit ($0.50/$1.00) - 2006/10/28 - 23:50:54 (ET)
Table 'Tanina' 10-max Seat #4 is the button
Seat 1: JMAC60 ($40.65 in chips) 
Seat 2: BBmack ($15.75 in chips) 
Seat 3: krofty ($8.10 in chips) 
Seat 4: Scylla ($15.10 in chips) 
Seat 5: budgirl49 ($22.75 in chips) 
Seat 6: SwaggerCanon ($29 in chips) 
Seat 7: Moooose ($40.05 in chips) 
Seat 8: 1,1,2,3,5 ($32.05 in chips) 
Seat 10: 1nyyfan ($26.95 in chips) 
budgirl49: posts small blind $0.25
SwaggerCanon: posts big blind $0.50
*** HOLE CARDS ***
Dealt to 1,1,2,3,5 [Jh 2d]
Moooose: folds 
1,1,2,3,5: folds 
1nyyfan: folds 
JMAC60: raises $0.50 to $1
BBmack: folds 
krofty: calls $1
Scylla: folds 
budgirl49: folds 
SwaggerCanon: calls $0.50
*** FLOP *** [Ah Ac 2h]
SwaggerCanon: checks 
JMAC60: bets $0.50
bruno1978 joins the table at seat #9 
krofty: folds 
SwaggerCanon: folds 
JMAC60 collected $3.10 from pot
JMAC60: doesn't show hand 
*** SUMMARY ***
Total pot $3.25 | Rake $0.15 
Board [Ah Ac 2h]
Seat 1: JMAC60 collected ($3.10)
Seat 2: BBmack folded before Flop (didn't bet)
Seat 3: krofty folded on the Flop
Seat 4: Scylla (button) folded before Flop (didn't bet)
Seat 5: budgirl49 (small blind) folded before Flop
Seat 6: SwaggerCanon (big blind) folded on the Flop
Seat 7: Moooose folded before Flop (didn't bet)
Seat 8: 1,1,2,3,5 folded before Flop (didn't bet)
Seat 10: 1nyyfan folded before Flop (didn't bet)



PokerStars Game #6809892198:  Hold'em Limit ($0.50/$1.00) - 2006/10/28 - 23:51:28 (ET)
Table 'Tanina' 10-max Seat #5 is the button
Seat 1: JMAC60 ($42.75 in chips) 
Seat 2: BBmack ($15.75 in chips) 
Seat 3: krofty ($7.10 in chips) 
Seat 4: Scylla ($15.10 in chips) 
Seat 5: budgirl49 ($22.50 in chips) 
Seat 6: SwaggerCanon ($28 in chips) 
Seat 7: Moooose ($40.05 in chips) 
Seat 8: 1,1,2,3,5 ($32.05 in chips) 
Seat 10: 1nyyfan ($26.95 in chips) 
SwaggerCanon: posts small blind $0.25
Moooose: posts big blind $0.50
bruno1978: sits out 
*** HOLE CARDS ***
Dealt to 1,1,2,3,5 [Ad 7h]
1,1,2,3,5: folds 
1nyyfan: folds 
JMAC60: folds 
BBmack: calls $0.50
krofty has timed out
krofty: folds 
krofty is sitting out
Scylla: folds 
krofty has returned
budgirl49: calls $0.50
SwaggerCanon: folds 
Moooose: checks 
*** FLOP *** [8s 8d Jd]
Moooose: checks 
BBmack: checks 
budgirl49: checks 
*** TURN *** [8s 8d Jd] [Kd]
Moooose: checks 
BBmack: checks 
budgirl49: checks 
*** RIVER *** [8s 8d Jd Kd] [Kc]
Moooose: checks 
BBmack: bets $1
budgirl49: folds 
Moooose: folds 
BBmack collected $1.70 from pot
BBmack: doesn't show hand 
*** SUMMARY ***
Total pot $1.75 | Rake $0.05 
Board [8s 8d Jd Kd Kc]
Seat 1: JMAC60 folded before Flop (didn't bet)
Seat 2: BBmack collected ($1.70)
Seat 3: krofty folded before Flop (didn't bet)
Seat 4: Scylla folded before Flop (didn't bet)
Seat 5: budgirl49 (button) folded on the River
Seat 6: SwaggerCanon (small blind) folded before Flop
Seat 7: Moooose (big blind) folded on the River
Seat 8: 1,1,2,3,5 folded before Flop (didn't bet)
Seat 10: 1nyyfan folded before Flop (didn't bet)



PokerStars Game #6809905953:  Hold'em Limit ($0.50/$1.00) - 2006/10/28 - 23:52:32 (ET)
Table 'Tanina' 10-max Seat #6 is the button
Seat 1: JMAC60 ($42.75 in chips) 
Seat 2: BBmack ($16.95 in chips) 
Seat 3: krofty ($7.10 in chips) 
Seat 4: Scylla ($15.10 in chips) 
Seat 5: budgirl49 ($22 in chips) 
Seat 6: SwaggerCanon ($27.75 in chips) 
Seat 7: Moooose ($39.55 in chips) 
Seat 8: 1,1,2,3,5 ($32.05 in chips) 
Seat 10: 1nyyfan ($26.95 in chips) 
Moooose: posts small blind $0.25
1,1,2,3,5: posts big blind $0.50
bruno1978: sits out 
*** HOLE CARDS ***
Dealt to 1,1,2,3,5 [Ac 8h]
1nyyfan: folds 
JMAC60: calls $0.50
BBmack: folds 
krofty: calls $0.50
Scylla: folds 
budgirl49: folds 
SwaggerCanon: folds 
Moooose: calls $0.25
1,1,2,3,5: checks 
*** FLOP *** [6d Qc Jc]
Moooose: checks 
1,1,2,3,5: checks 
budgirl49 is sitting out
JMAC60: checks 
krofty: bets $0.50
Moooose: folds 
1,1,2,3,5: folds 
JMAC60: calls $0.50
*** TURN *** [6d Qc Jc] [3d]
JMAC60: checks 
krofty: bets $1
JMAC60: calls $1
*** RIVER *** [6d Qc Jc 3d] [9d]
JMAC60: checks 
krofty: bets $1
JMAC60: calls $1
*** SHOW DOWN ***
krofty: shows [4s Qs] (a pair of Queens)
JMAC60: mucks hand 
krofty collected $6.70 from pot
*** SUMMARY ***
Total pot $7 | Rake $0.30 
Board [6d Qc Jc 3d 9d]
Seat 1: JMAC60 mucked [Ks Js]
Seat 2: BBmack folded before Flop (didn't bet)
Seat 3: krofty showed [4s Qs] and won ($6.70) with a pair of Queens
Seat 4: Scylla folded before Flop (didn't bet)
Seat 5: budgirl49 folded before Flop (didn't bet)
Seat 6: SwaggerCanon (button) folded before Flop (didn't bet)
Seat 7: Moooose (small blind) folded on the Flop
Seat 8: 1,1,2,3,5 (big blind) folded on the Flop
Seat 10: 1nyyfan folded before Flop (didn't bet)



PokerStars Game #6809918411:  Hold'em Limit ($0.50/$1.00) - 2006/10/28 - 23:53:30 (ET)
Table 'Tanina' 10-max Seat #7 is the button
Seat 1: JMAC60 ($39.75 in chips) 
Seat 2: BBmack ($16.95 in chips) 
Seat 3: krofty ($10.80 in chips) 
Seat 4: Scylla ($15.10 in chips) 
Seat 6: SwaggerCanon ($27.75 in chips) 
Seat 7: Moooose ($39.05 in chips) 
Seat 8: 1,1,2,3,5 ($31.55 in chips) 
Seat 9: bruno1978 ($9.45 in chips) 
Seat 10: 1nyyfan ($26.95 in chips) 
1,1,2,3,5: posts small blind $0.25
bruno1978: posts big blind $0.50
*** HOLE CARDS ***
Dealt to 1,1,2,3,5 [Tc 7s]
1nyyfan: folds 
JMAC60: folds 
BBmack: folds 
krofty: folds 
Scylla: folds 
SwaggerCanon: folds 
Moooose: folds 
1,1,2,3,5: folds 
bruno1978 collected $0.50 from pot
bruno1978: doesn't show hand 
*** SUMMARY ***
Total pot $0.50 | Rake $0 
Seat 1: JMAC60 folded before Flop (didn't bet)
Seat 2: BBmack folded before Flop (didn't bet)
Seat 3: krofty folded before Flop (didn't bet)
Seat 4: Scylla folded before Flop (didn't bet)
Seat 6: SwaggerCanon folded before Flop (didn't bet)
Seat 7: Moooose (button) folded before Flop (didn't bet)
Seat 8: 1,1,2,3,5 (small blind) folded before Flop
Seat 9: bruno1978 (big blind) collected ($0.50)
Seat 10: 1nyyfan folded before Flop (didn't bet)



PokerStars Game #6809922343:  Hold'em Limit ($0.50/$1.00) - 2006/10/28 - 23:53:47 (ET)
Table 'Tanina' 10-max Seat #8 is the button
Seat 1: JMAC60 ($39.75 in chips) 
Seat 2: BBmack ($16.95 in chips) 
Seat 3: krofty ($10.80 in chips) 
Seat 4: Scylla ($15.10 in chips) 
Seat 6: SwaggerCanon ($27.75 in chips) 
Seat 7: Moooose ($39.05 in chips) 
Seat 8: 1,1,2,3,5 ($31.30 in chips) 
Seat 9: bruno1978 ($9.70 in chips) 
Seat 10: 1nyyfan ($26.95 in chips) 
bruno1978: posts small blind $0.25
1nyyfan: posts big blind $0.50
*** HOLE CARDS ***
Dealt to 1,1,2,3,5 [3d 5h]
JMAC60: raises $0.50 to $1
BBmack: folds 
krofty: folds 
Scylla: folds 
SwaggerCanon: folds 
Moooose: folds 
1,1,2,3,5: folds 
bruno1978: folds 
1nyyfan: folds 
JMAC60 collected $1.25 from pot
JMAC60: doesn't show hand 
*** SUMMARY ***
Total pot $1.25 | Rake $0 
Seat 1: JMAC60 collected ($1.25)
Seat 2: BBmack folded before Flop (didn't bet)
Seat 3: krofty folded before Flop (didn't bet)
Seat 4: Scylla folded before Flop (didn't bet)
Seat 6: SwaggerCanon folded before Flop (didn't bet)
Seat 7: Moooose folded before Flop (didn't bet)
Seat 8: 1,1,2,3,5 (button) folded before Flop (didn't bet)
Seat 9: bruno1978 (small blind) folded before Flop
Seat 10: 1nyyfan (big blind) folded before Flop



PokerStars Game #6809927032:  Hold'em Limit ($0.50/$1.00) - 2006/10/28 - 23:54:10 (ET)
Table 'Tanina' 10-max Seat #9 is the button
Seat 1: JMAC60 ($40.50 in chips) 
Seat 2: BBmack ($16.95 in chips) 
Seat 3: krofty ($10.80 in chips) 
Seat 4: Scylla ($15.10 in chips) 
Seat 6: SwaggerCanon ($27.75 in chips) 
Seat 7: Moooose ($39.05 in chips) 
Seat 8: 1,1,2,3,5 ($31.30 in chips) 
Seat 9: bruno1978 ($9.45 in chips) 
Seat 10: 1nyyfan ($26.45 in chips) 
1nyyfan: posts small blind $0.25
JMAC60: posts big blind $0.50
*** HOLE CARDS ***
Dealt to 1,1,2,3,5 [Ad Ac]
BBmack: folds 
krofty: raises $0.50 to $1
Scylla: folds 
SwaggerCanon: folds 
Moooose: folds 
1,1,2,3,5: raises $0.50 to $1.50
bruno1978: folds 
1nyyfan: folds 
JMAC60: folds 
krofty: calls $0.50
*** FLOP *** [Js Kh 8c]
krofty: checks 
1,1,2,3,5: bets $0.50
krofty: calls $0.50
*** TURN *** [Js Kh 8c] [5c]
krofty: checks 
1,1,2,3,5: bets $1
krofty: calls $1
*** RIVER *** [Js Kh 8c 5c] [2c]
krofty: checks 
1,1,2,3,5: checks 
*** SHOW DOWN ***
krofty: shows [As Tc] (high card Ace)
1,1,2,3,5: shows [Ad Ac] (a pair of Aces)
1,1,2,3,5 collected $6.45 from pot
*** SUMMARY ***
Total pot $6.75 | Rake $0.30 
Board [Js Kh 8c 5c 2c]
Seat 1: JMAC60 (big blind) folded before Flop
Seat 2: BBmack folded before Flop (didn't bet)
Seat 3: krofty showed [As Tc] and lost with high card Ace
Seat 4: Scylla folded before Flop (didn't bet)
Seat 6: SwaggerCanon folded before Flop (didn't bet)
Seat 7: Moooose folded before Flop (didn't bet)
Seat 8: 1,1,2,3,5 showed [Ad Ac] and won ($6.45) with a pair of Aces
Seat 9: bruno1978 (button) folded before Flop (didn't bet)
Seat 10: 1nyyfan (small blind) folded before Flop



PokerStars Game #6809933629:  Hold'em Limit ($0.50/$1.00) - 2006/10/28 - 23:54:41 (ET)
Table 'Tanina' 10-max Seat #10 is the button
Seat 1: JMAC60 ($40 in chips) 
Seat 2: BBmack ($16.95 in chips) 
Seat 3: krofty ($7.80 in chips) 
Seat 4: Scylla ($15.10 in chips) 
Seat 6: SwaggerCanon ($27.75 in chips) 
Seat 7: Moooose ($39.05 in chips) 
Seat 8: 1,1,2,3,5 ($34.75 in chips) 
Seat 9: bruno1978 ($9.45 in chips) 
Seat 10: 1nyyfan ($26.20 in chips) 
JMAC60: posts small blind $0.25
BBmack: posts big blind $0.50
*** HOLE CARDS ***
Dealt to 1,1,2,3,5 [9s 8s]
krofty: folds 
Scylla: folds 
SwaggerCanon: folds 
Moooose: calls $0.50
1,1,2,3,5: folds 
bruno1978: folds 
1nyyfan: folds 
JMAC60: calls $0.25
BBmack: checks 
*** FLOP *** [8h 3s Kd]
JMAC60: bets $0.50
BBmack: folds 
Moooose: raises $0.50 to $1
JMAC60: raises $0.50 to $1.50
Moooose: folds 
JMAC60 collected $3.35 from pot
JMAC60: doesn't show hand 
*** SUMMARY ***
Total pot $3.50 | Rake $0.15 
Board [8h 3s Kd]
Seat 1: JMAC60 (small blind) collected ($3.35)
Seat 2: BBmack (big blind) folded on the Flop
Seat 3: krofty folded before Flop (didn't bet)
Seat 4: Scylla folded before Flop (didn't bet)
Seat 6: SwaggerCanon folded before Flop (didn't bet)
Seat 7: Moooose folded on the Flop
Seat 8: 1,1,2,3,5 folded before Flop (didn't bet)
Seat 9: bruno1978 folded before Flop (didn't bet)
Seat 10: 1nyyfan (button) folded before Flop (didn't bet)



PokerStars Game #6809943349:  Hold'em Limit ($0.50/$1.00) - 2006/10/28 - 23:55:26 (ET)
Table 'Tanina' 10-max Seat #1 is the button
Seat 1: JMAC60 ($41.85 in chips) 
Seat 2: BBmack ($16.45 in chips) 
Seat 3: krofty ($7.80 in chips) 
Seat 4: Scylla ($15.10 in chips) 
Seat 6: SwaggerCanon ($27.75 in chips) 
Seat 7: Moooose ($37.55 in chips) 
Seat 8: 1,1,2,3,5 ($34.75 in chips) 
Seat 9: bruno1978 ($9.45 in chips) 
Seat 10: 1nyyfan ($26.20 in chips) 
BBmack: posts small blind $0.25
krofty: posts big blind $0.50
*** HOLE CARDS ***
Dealt to 1,1,2,3,5 [Jc 7h]
Scylla: folds 
SwaggerCanon: folds 
Moooose: folds 
1,1,2,3,5: folds 
budgirl49 has returned
bruno1978: folds 
1nyyfan: folds 
JMAC60: folds 
BBmack: calls $0.25
krofty: checks 
*** FLOP *** [Qc Td 2d]
BBmack: bets $0.50
krofty: raises $0.50 to $1
BBmack: calls $0.50
*** TURN *** [Qc Td 2d] [8d]
BBmack: bets $1
krofty: calls $1
*** RIVER *** [Qc Td 2d 8d] [As]
BBmack: bets $1
krofty: folds 
BBmack collected $4.80 from pot
BBmack: doesn't show hand 
*** SUMMARY ***
Total pot $5 | Rake $0.20 
Board [Qc Td 2d 8d As]
Seat 1: JMAC60 (button) folded before Flop (didn't bet)
Seat 2: BBmack (small blind) collected ($4.80)
Seat 3: krofty (big blind) folded on the River
Seat 4: Scylla folded before Flop (didn't bet)
Seat 6: SwaggerCanon folded before Flop (didn't bet)
Seat 7: Moooose folded before Flop (didn't bet)
Seat 8: 1,1,2,3,5 folded before Flop (didn't bet)
Seat 9: bruno1978 folded before Flop (didn't bet)
Seat 10: 1nyyfan folded before Flop (didn't bet)



PokerStars Game #6809954488:  Hold'em Limit ($0.50/$1.00) - 2006/10/28 - 23:56:19 (ET)
Table 'Tanina' 10-max Seat #2 is the button
Seat 1: JMAC60 ($41.85 in chips) 
Seat 2: BBmack ($18.75 in chips) 
Seat 3: krofty ($5.30 in chips) 
Seat 4: Scylla ($15.10 in chips) 
Seat 5: budgirl49 ($22 in chips) 
Seat 6: SwaggerCanon ($27.75 in chips) 
Seat 7: Moooose ($37.55 in chips) 
Seat 8: 1,1,2,3,5 ($34.75 in chips) 
Seat 9: bruno1978 ($9.45 in chips) 
Seat 10: 1nyyfan ($26.20 in chips) 
krofty: posts small blind $0.25
Scylla: posts big blind $0.50
*** HOLE CARDS ***
Dealt to 1,1,2,3,5 [8s 6d]
budgirl49: folds 
SwaggerCanon: folds 
Moooose: calls $0.50
1,1,2,3,5: folds 
bruno1978: raises $0.50 to $1
1nyyfan: folds 
JMAC60: folds 
BBmack: calls $1
krofty: folds 
Scylla: calls $0.50
Moooose: calls $0.50
*** FLOP *** [2s 5d 3s]
Scylla: checks 
Moooose: checks 
bruno1978: bets $0.50
BBmack: raises $0.50 to $1
Scylla: folds 
Moooose: folds 
bruno1978: raises $0.50 to $1.50
BBmack: calls $0.50
*** TURN *** [2s 5d 3s] [Tc]
bruno1978: bets $1
BBmack: raises $1 to $2
bruno1978: calls $1
*** RIVER *** [2s 5d 3s Tc] [5c]
bruno1978: bets $1
BBmack: raises $1 to $2
bruno1978: calls $1
*** SHOW DOWN ***
BBmack: shows [Ac 4c] (a straight, Ace to Five)
bruno1978: mucks hand 
BBmack collected $14.75 from pot
*** SUMMARY ***
Total pot $15.25 | Rake $0.50 
Board [2s 5d 3s Tc 5c]
Seat 1: JMAC60 folded before Flop (didn't bet)
Seat 2: BBmack (button) showed [Ac 4c] and won ($14.75) with a straight, Ace to Five
Seat 3: krofty (small blind) folded before Flop
Seat 4: Scylla (big blind) folded on the Flop
Seat 5: budgirl49 folded before Flop (didn't bet)
Seat 6: SwaggerCanon folded before Flop (didn't bet)
Seat 7: Moooose folded on the Flop
Seat 8: 1,1,2,3,5 folded before Flop (didn't bet)
Seat 9: bruno1978 mucked [Ad As]
Seat 10: 1nyyfan folded before Flop (didn't bet)



PokerStars Game #6809967095:  Hold'em Limit ($0.50/$1.00) - 2006/10/28 - 23:57:19 (ET)
Table 'Tanina' 10-max Seat #3 is the button
Seat 1: JMAC60 ($41.85 in chips) 
Seat 2: BBmack ($27 in chips) 
Seat 3: krofty ($5.05 in chips) 
Seat 4: Scylla ($14.10 in chips) 
Seat 5: budgirl49 ($22 in chips) 
Seat 6: SwaggerCanon ($27.75 in chips) 
Seat 7: Moooose ($36.55 in chips) 
Seat 8: 1,1,2,3,5 ($34.75 in chips) 
Seat 9: bruno1978 ($2.95 in chips) 
Seat 10: 1nyyfan ($26.20 in chips) 
Scylla: posts small blind $0.25
budgirl49: posts big blind $0.50
*** HOLE CARDS ***
Dealt to 1,1,2,3,5 [3s 7d]
SwaggerCanon: folds 
bruno1978 said, "omg * * ck it"
Moooose: folds 
1,1,2,3,5: folds 
bruno1978 said, "i lost 5 AA in a row now"
bruno1978: folds 
1nyyfan: folds 
JMAC60: folds 
BBmack: folds 
krofty: folds 
bruno1978 said, "!!!"
Scylla: raises $0.50 to $1
budgirl49: calls $0.50
*** FLOP *** [8s Th Ac]
Scylla: bets $0.50
budgirl49: folds 
Scylla collected $1.90 from pot
Scylla: doesn't show hand 
*** SUMMARY ***
Total pot $2 | Rake $0.10 
Board [8s Th Ac]
Seat 1: JMAC60 folded before Flop (didn't bet)
Seat 2: BBmack folded before Flop (didn't bet)
Seat 3: krofty (button) folded before Flop (didn't bet)
Seat 4: Scylla (small blind) collected ($1.90)
Seat 5: budgirl49 (big blind) folded on the Flop
Seat 6: SwaggerCanon folded before Flop (didn't bet)
Seat 7: Moooose folded before Flop (didn't bet)
Seat 8: 1,1,2,3,5 folded before Flop (didn't bet)
Seat 9: bruno1978 folded before Flop (didn't bet)
Seat 10: 1nyyfan folded before Flop (didn't bet)



PokerStars Game #6809973226:  Hold'em Limit ($0.50/$1.00) - 2006/10/28 - 23:57:48 (ET)
Table 'Tanina' 10-max Seat #4 is the button
Seat 1: JMAC60 ($41.85 in chips) 
Seat 2: BBmack ($27 in chips) 
Seat 3: krofty ($5.05 in chips) 
Seat 4: Scylla ($15 in chips) 
Seat 5: budgirl49 ($21 in chips) 
Seat 6: SwaggerCanon ($27.75 in chips) 
Seat 7: Moooose ($36.55 in chips) 
Seat 8: 1,1,2,3,5 ($34.75 in chips) 
Seat 9: bruno1978 ($2.95 in chips) 
Seat 10: 1nyyfan ($26.20 in chips) 
budgirl49: posts small blind $0.25
SwaggerCanon: posts big blind $0.50
*** HOLE CARDS ***
Dealt to 1,1,2,3,5 [Kh Jd]
Moooose: folds 
bruno1978 said, "in 3 hours"
1,1,2,3,5: calls $0.50
bruno1978 said, "and im down 50 bucks f off"
bruno1978: folds 
1nyyfan: folds 
JMAC60: raises $0.50 to $1
BBmack: folds 
krofty: folds 
bruno1978 said, "lost 12 out of 13 AA KK QQ"
Scylla: folds 
budgirl49: calls $0.75
SwaggerCanon: folds 
1,1,2,3,5: calls $0.50
*** FLOP *** [6s 4c 7c]
budgirl49: checks 
1,1,2,3,5: checks 
JMAC60: bets $0.50
budgirl49: folds 
1,1,2,3,5: folds 
JMAC60 collected $3.35 from pot
JMAC60: doesn't show hand 
*** SUMMARY ***
Total pot $3.50 | Rake $0.15 
Board [6s 4c 7c]
Seat 1: JMAC60 collected ($3.35)
Seat 2: BBmack folded before Flop (didn't bet)
Seat 3: krofty folded before Flop (didn't bet)
Seat 4: Scylla (button) folded before Flop (didn't bet)
Seat 5: budgirl49 (small blind) folded on the Flop
Seat 6: SwaggerCanon (big blind) folded before Flop
Seat 7: Moooose folded before Flop (didn't bet)
Seat 8: 1,1,2,3,5 folded on the Flop
Seat 9: bruno1978 folded before Flop (didn't bet)
Seat 10: 1nyyfan folded before Flop (didn't bet)



PokerStars Game #6809983686:  Hold'em Limit ($0.50/$1.00) - 2006/10/28 - 23:58:38 (ET)
Table 'Tanina' 10-max Seat #5 is the button
Seat 1: JMAC60 ($44.20 in chips) 
Seat 2: BBmack ($27 in chips) 
Seat 3: krofty ($5.05 in chips) 
Seat 4: Scylla ($15 in chips) 
Seat 5: budgirl49 ($20 in chips) 
Seat 6: SwaggerCanon ($27.25 in chips) 
Seat 7: Moooose ($36.55 in chips) 
Seat 8: 1,1,2,3,5 ($33.75 in chips) 
Seat 9: bruno1978 ($2.95 in chips) 
Seat 10: 1nyyfan ($26.20 in chips) 
SwaggerCanon: posts small blind $0.25
Moooose: posts big blind $0.50
*** HOLE CARDS ***
Dealt to 1,1,2,3,5 [2c 6d]
Scylla said, "looks like you might want to start folding those hands"
1,1,2,3,5: folds 
Scylla said, "preflop??"
bruno1978: folds 
1nyyfan: folds 
JMAC60: folds 
BBmack: calls $0.50
bruno1978 said, "usually im 50-100 up per day"
krofty: folds 
Scylla: calls $0.50
budgirl49: calls $0.50
SwaggerCanon: raises $0.50 to $1
bruno1978 said, "and now im down 50"
Moooose: folds 
BBmack: calls $0.50
Scylla: calls $0.50
budgirl49: calls $0.50
*** FLOP *** [3d As Kh]
SwaggerCanon: bets $0.50
bruno1978 said, "what a run"
BBmack: calls $0.50
Scylla: folds 
budgirl49: calls $0.50
*** TURN *** [3d As Kh] [6s]
bruno1978 said, "never lost 12 of 13 QQ KK AA"
SwaggerCanon: bets $1
BBmack: calls $1
budgirl49: folds 
*** RIVER *** [3d As Kh 6s] [4c]
SwaggerCanon: bets $1
BBmack: folds 
SwaggerCanon collected $7.65 from pot
*** SUMMARY ***
Total pot $8 | Rake $0.35 
Board [3d As Kh 6s 4c]
Seat 1: JMAC60 folded before Flop (didn't bet)
Seat 2: BBmack folded on the River
Seat 3: krofty folded before Flop (didn't bet)
Seat 4: Scylla folded on the Flop
Seat 5: budgirl49 (button) folded on the Turn
Seat 6: SwaggerCanon (small blind) collected ($7.65)
Seat 7: Moooose (big blind) folded before Flop
Seat 8: 1,1,2,3,5 folded before Flop (didn't bet)
Seat 9: bruno1978 folded before Flop (didn't bet)
Seat 10: 1nyyfan folded before Flop (didn't bet)



PokerStars Game #6809998167:  Hold'em Limit ($0.50/$1.00) - 2006/10/28 - 23:59:48 (ET)
Table 'Tanina' 10-max Seat #6 is the button
Seat 1: JMAC60 ($44.20 in chips) 
Seat 2: BBmack ($24.50 in chips) 
Seat 3: krofty ($5.05 in chips) 
Seat 4: Scylla ($14 in chips) 
Seat 5: budgirl49 ($18.50 in chips) 
Seat 6: SwaggerCanon ($32.40 in chips) 
Seat 7: Moooose ($36.05 in chips) 
Seat 8: 1,1,2,3,5 ($33.75 in chips) 
Seat 9: bruno1978 ($2.95 in chips) 
Seat 10: 1nyyfan ($26.20 in chips) 
Moooose: posts small blind $0.25
1,1,2,3,5: posts big blind $0.50
*** HOLE CARDS ***
Dealt to 1,1,2,3,5 [5s 6h]
Moooose said, "never say, "never"."
bruno1978: folds 
1nyyfan: folds 
JMAC60: folds 
BBmack: folds 
krofty: folds 
Scylla: folds 
budgirl49: raises $0.50 to $1
SwaggerCanon: folds 
Moooose: folds 
1,1,2,3,5: folds 
budgirl49 collected $1.25 from pot
*** SUMMARY ***
Total pot $1.25 | Rake $0 
Seat 1: JMAC60 folded before Flop (didn't bet)
Seat 2: BBmack folded before Flop (didn't bet)
Seat 3: krofty folded before Flop (didn't bet)
Seat 4: Scylla folded before Flop (didn't bet)
Seat 5: budgirl49 collected ($1.25)
Seat 6: SwaggerCanon (button) folded before Flop (didn't bet)
Seat 7: Moooose (small blind) folded before Flop
Seat 8: 1,1,2,3,5 (big blind) folded before Flop
Seat 9: bruno1978 folded before Flop (didn't bet)
Seat 10: 1nyyfan folded before Flop (didn't bet)



